㑳	㑇		
㞞	𪨊		
㨗	捷		
㩜	㨫		
䈰	筲		
䥑	鿏		
䰾	鲃		
䲘	鳤		
䴉	鹮		
丟	丢		
並	并		
亂	乱		
亙	亘		
亞	亚		
佇	伫		
佈	布		
佔	占		
併	并		
來	来		
侖	仑		
侶	侣		
侷	局		
俁	俣		
係	系		
俓	𠇹		
俔	伣		
俠	侠		
倀	伥		
倆	俩		
倉	仓		
個	个		
們	们		
倖	幸		
倫	伦		
偉	伟		
偪	逼		
側	侧		
偵	侦		
偽	伪		
傌	㐷		
傑	杰		
傖	伧		
傘	伞		
備	备		
傚	效		
傭	佣		
傯	偬		
傳	传		
傴	伛		
債	债		
傷	伤		
傾	倾		
僂	偻		
僅	仅		
僉	佥		
僑	侨		
僕	仆		
僤	𫢸		
僥	侥		
僨	偾		
僱	雇		
價	价		
儀	仪		
儁	俊		
儂	侬		
億	亿		
儈	侩		
儉	俭		
儐	傧		
儔	俦		
儕	侪		
儗	拟		
儘	尽		
償	偿		
優	优		
儲	储		
儷	俪		
儸	㑩		
儺	傩		
儻	傥		
儼	俨		
兇	凶		
兌	兑		
兒	儿		
兗	兖		
內	内		
兩	两		
冊	册		
冪	幂		
凈	净		
凍	冻		
凜	凛		
凱	凯		
刪	删		
剄	刭		
則	则		
剉	锉		
剎	刹		
剗	刬		
剛	刚		
剝	剥		
剮	剐		
剴	剀		
創	创		
剷	铲		
剹	戮		
劃	划		
劇	剧		
劉	刘		
劊	刽		
劌	刿		
劍	剑		
劑	剂		
勁	劲		
動	动		
務	务		
勛	勋		
勝	胜		
勢	势		
勣	𪟝		
勦	剿		
勩	勚		
勱	劢		
勳	勋		
勵	励		
勸	劝		
勻	匀		
匭	匦		
匯	汇		
匱	匮		
區	区		
協	协		
卹	恤		
卻	却		
厙	厍		
厭	厌		
厲	厉		
厴	厣		
參	参ǀ叁		
叢	丛		
吳	吴		
吶	呐		
呂	吕		
咼	呙		
員	员		
唄	呗		
唚	吣		
問	问		
啞	哑		
啟	启		
啢	唡		
喎	㖞		
喚	唤		
喪	丧		
喬	乔		
喲	哟		
嗆	呛		
嗇	啬		
嗊	唝		
嗎	吗		
嗚	呜		
嗩	唢		
嗰	𠮶		
嗶	哔		
嘆	叹		
嘊	啀		
嘍	喽		
嘑	呼		
嘓	啯		
嘔	呕		
嘖	啧		
嘗	尝		
嘜	唛		
嘩	哗		
嘮	唠		
嘯	啸		
嘰	叽		
嘵	哓		
嘸	呒		
嘽	啴		
噁	𫫇ǀ恶		
噅	𠯠		
噓	嘘		
噚	㖊		
噝	咝		
噠	哒		
噥	哝		
噦	哕		
噯	嗳		
噲	哙		
噴	喷		
噸	吨		
噹	当		
嚀	咛		
嚇	吓		
嚌	哜		
嚐	尝		
嚕	噜		
嚙	啮		
嚥	咽		
嚦	呖		
嚨	咙		
嚮	向		
嚲	亸		
嚳	喾		
嚴	严		
嚶	嘤		
囀	啭		
囁	嗫		
囂	嚣		
囅	冁		
囈	呓		
囉	啰ǀ罗		
囌	苏		
囑	嘱		
囓	啮		
囪	囱		
圇	囵		
國	国		
圍	围		
園	园		
圓	圆		
圖	图		
團	团		
坵	丘		
埡	垭		
埳	坎		
執	执		
堅	坚		
堊	垩		
堖	垴		
堝	埚		
堯	尧		
報	报		
場	场		
塊	块		
塋	茔		
塏	垲		
塒	埘		
塗	涂		
塚	冢		
塢	坞		
塤	埙		
塵	尘		
塹	堑		
塿	𪣻		
墊	垫		
墜	坠		
墠	𫮃		
墮	堕		
墳	坟		
墻	墙		
墾	垦		
壇	坛		
壈	𡒄		
壋	垱		
壓	压		
壘	垒		
壙	圹		
壚	垆		
壞	坏		
壟	垄		
壢	坜		
壩	坝		
壪	塆		
壯	壮		
壺	壶		
壼	壸		
壽	寿		
夠	够		
夢	梦		
奐	奂		
奧	奥		
奩	奁		
奪	夺		
奮	奋		
奼	姹		
妝	妆		
姍	姗		
姦	奸		
姪	侄		
娛	娱		
婁	娄		
婦	妇		
婭	娅		
媧	娲		
媯	妫		
媰	㛀		
媼	媪		
媽	妈		
嫋	袅		
嫗	妪		
嫰	嫩		
嫵	妩		
嫻	娴		
嫿	婳		
嬃	媭		
嬈	娆		
嬋	婵		
嬌	娇		
嬙	嫱		
嬝	袅		
嬡	嫒		
嬤	嬷		
嬪	嫔		
嬭	奶		
嬰	婴		
嬸	婶		
孃	娘		
孌	娈		
孫	孙		
學	学		
孻	𡥧		
孿	孪		
宮	宫		
寠	𪧘		
寢	寝		
實	实		
寧	宁		
審	审		
寫	写		
寬	宽		
寳	宝		
寵	宠		
寶	宝		
將	将		
專	专		
尋	寻		
對	对		
導	导		
尷	尴		
屆	届		
屍	尸		
屜	屉		
屢	屡		
層	层		
屨	屦		
屬	属		
屭	屃		
岅	坂		
岡	冈		
峴	岘		
島	岛		
峽	峡		
崍	崃		
崑	昆		
崗	岗		
崙	仑		
崢	峥		
崬	岽		
嵐	岚		
嵗	岁		
嵼	𡶴		
嵾	㟥		
嶁	嵝		
嶄	崭		
嶇	岖		
嶔	嵚		
嶗	崂		
嶠	峤		
嶢	峣		
嶧	峄		
嶨	峃		
嶮	崄		
嶴	岙		
嶸	嵘		
嶺	岭		
嶼	屿		
嶽	岳		
巆	𫶕		
巋	岿		
巒	峦		
巔	巅		
巖	岩		
巘	𪩘		
巰	巯		
巹	卺		
帥	帅		
師	师		
帳	帐		
帶	带		
幀	帧		
幃	帏		
幗	帼		
幘	帻		
幙	幕		
幟	帜		
幣	币		
幫	帮		
幬	帱		
幹	干		
幾	几		
庫	库		
廁	厕		
廂	厢		
廄	厩		
廈	厦		
廎	庼		
廚	厨		
廝	厮		
廞	𫷷		
廟	庙		
廠	厂		
廡	庑		
廢	废		
廣	广		
廩	廪		
廬	庐		
廳	厅		
廹	迫		
弒	弑		
弔	吊		
弳	弪		
張	张		
強	强		
彄	𫸩		
彆	别		
彈	弹		
彌	弥		
彎	弯		
彔	录		
彙	汇		
彞	彝		
彠	彟		
彥	彦		
彲	彨		
彿	佛		
後	后		
徑	径		
從	从		
徠	徕		
復	复		
徹	彻		
恆	恒		
恥	耻		
悅	悦		
悞	悮		
悵	怅		
悶	闷		
悽	凄		
惡	恶		
惱	恼		
惲	恽		
惷	蠢		
惻	恻		
愛	爱		
愜	惬		
愨	悫		
愴	怆		
愷	恺		
愾	忾		
慄	栗		
態	态		
慍	愠		
慘	惨		
慚	惭		
慟	恸		
慣	惯		
慤	悫		
慪	怄		
慫	怂		
慮	虑		
慳	悭		
慴	慑		
慶	庆		
慼	戚		
慾	欲		
憂	忧		
憊	惫		
憐	怜		
憑	凭		
憒	愦		
憖	慭		
憚	惮		
憤	愤		
憫	悯		
憮	怃		
憲	宪		
憶	忆		
憹	𢙐		
懃	勤		
懇	恳		
應	应		
懌	怿		
懍	懔		
懟	怼		
懣	懑		
懤	㤽		
懨	恹		
懲	惩		
懶	懒		
懷	怀		
懸	悬		
懺	忏		
懼	惧		
懾	慑		
戀	恋		
戇	戆		
戔	戋		
戧	戗		
戩	戬		
戰	战		
戲	戏		
戶	户		
拋	抛		
挾	挟		
捨	舍		
捫	扪		
捲	卷		
掃	扫		
掄	抡		
掗	挜		
掙	挣		
掛	挂		
採	采		
揀	拣		
揚	扬		
換	换		
揮	挥		
揹	背		
搆	构		
損	损		
搖	摇		
搗	捣		
搵	揾		
搶	抢		
搾	榨		
摑	掴		
摜	掼		
摟	搂		
摯	挚		
摳	抠		
摶	抟		
摻	掺		
撈	捞		
撏	挦		
撐	撑		
撓	挠		
撝	㧑		
撟	挢		
撣	掸		
撥	拨		
撦	扯		
撫	抚		
撲	扑		
撳	揿		
撻	挞		
撾	挝		
撿	捡		
擁	拥		
擄	掳		
擇	择		
擊	击		
擋	挡		
擔	担		
據	据		
擠	挤		
擧	举		
擫	𢬍		
擬	拟		
擯	摈		
擰	拧		
擱	搁		
擲	掷		
擴	扩		
擷	撷		
擺	摆		
擻	擞		
擼	撸		
擽	㧰		
擾	扰		
攄	摅		
攆	撵		
攏	拢		
攔	拦		
攖	撄		
攙	搀		
攛	撺		
攜	携		
攝	摄		
攢	攒		
攣	挛		
攤	摊		
攪	搅		
攬	揽		
攷	考		
敂	叩		
敗	败		
敘	叙		
敱	敳		
敵	敌		
數	数		
斂	敛		
斃	毙		
斕	斓		
斬	斩		
斲	斫		
斷	断		
旂	旗		
昰	是		
時	时		
晉	晋		
晛	𬀪		
晝	昼		
暈	晕		
暉	晖		
暐	𬀩		
暘	旸		
暢	畅		
暫	暂		
暱	昵		
曄	晔		
曆	历		
曇	昙		
曉	晓		
曏	向		
曖	暧		
曠	旷		
曨	昽		
曬	晒		
書	书		
會	会		
朞	期		
朢	望		
朧	胧		
東	东		
枴	拐		
柵	栅		
栞	刊		
桿	杆		
梔	栀		
梘	枧		
條	条		
梟	枭		
棄	弃		
棖	枨		
棗	枣		
棟	栋		
棧	栈		
棲	栖		
棶	梾		
椏	桠		
椷	缄		
楄	匾		
楊	杨		
楓	枫		
楥	楦		
楨	桢		
業	业		
極	极		
榪	杩		
榮	荣		
榲	榅		
榿	桤		
槀	槁		
構	构		
槍	枪		
槓	杠		
槤	梿		
槧	椠		
槨	椁		
槮	椮		
槳	桨		
樁	桩		
樂	乐		
樅	枞		
樑	梁		
樓	楼		
標	标		
樞	枢		
樣	样		
樸	朴		
樹	树		
樺	桦		
樿	椫		
橈	桡		
橋	桥		
機	机		
橢	椭		
橫	横		
檁	檩		
檉	柽		
檔	档		
檜	桧		
檟	槚		
檢	检		
檣	樯		
檮	梼		
檯	台		
檳	槟		
檸	柠		
檻	槛		
櫂	棹		
櫃	柜		
櫓	橹		
櫚	榈		
櫛	栉		
櫝	椟		
櫞	橼		
櫟	栎		
櫥	橱		
櫧	槠		
櫨	栌		
櫪	枥		
櫫	橥		
櫬	榇		
櫱	蘖		
櫳	栊		
櫸	榉		
櫺	棂		
櫻	樱		
欄	栏		
權	权		
欏	椤		
欒	栾		
欖	榄		
欞	棂		
欽	钦		
歎	叹		
歐	欧		
歟	欤		
歡	欢		
歲	岁		
歷	历		
歸	归		
歿	殁		
殀	夭		
殘	残		
殞	殒		
殢	𣨼		
殤	殇		
殫	殚		
殭	僵		
殮	殓		
殯	殡		
殰	㱩		
殲	歼		
殺	杀		
殼	壳		
殽	肴		
毀	毁		
毆	殴		
毿	毵		
氂	牦		
氈	毡		
氌	氇		
氣	气		
氫	氢		
氬	氩		
氳	氲		
決	决		
沒	没		
沖	冲		
況	况		
洩	泄		
洶	汹		
浹	浃		
涇	泾		
涖	莅		
涼	凉		
淒	凄		
淚	泪		
淥	渌		
淨	净		
淪	沦		
淵	渊		
淶	涞		
淺	浅		
渙	涣		
減	减		
渢	沨		
渦	涡		
測	测		
渾	浑		
湊	凑		
湋	𣲗		
湞	浈		
湧	涌		
湯	汤		
湼	涅		
溈	沩		
準	准		
溝	沟		
溫	温		
溮	浉		
溳	涢		
滄	沧		
滅	灭		
滌	涤		
滎	荥		
滬	沪		
滯	滞		
滲	渗		
滷	卤		
滸	浒		
滻	浐		
滾	滚		
滿	满		
漁	渔		
漊	溇		
漚	沤		
漢	汉		
漣	涟		
漬	渍		
漲	涨		
漵	溆		
漸	渐		
漿	浆		
潁	颍		
潑	泼		
潔	洁		
潕	𣲘		
潚	㴋		
潛	潜		
潤	润		
潯	浔		
潰	溃		
潷	滗		
潿	涠		
澀	涩		
澆	浇		
澇	涝		
澗	涧		
澠	渑		
澤	泽		
澦	滪		
澫	𬇕		
澮	浍		
澱	淀		
濁	浊		
濃	浓		
濆	𣸣		
濕	湿		
濘	泞		
濛	蒙		
濜	浕		
濟	济		
濤	涛		
濫	滥		
濰	潍		
濱	滨		
濺	溅		
濼	泺		
濾	滤		
瀅	滢		
瀆	渎		
瀉	泻		
瀋	沈		
瀏	浏		
瀕	濒		
瀘	泸		
瀝	沥		
瀟	潇		
瀠	潆		
瀦	潴		
瀧	泷		
瀨	濑		
瀰	弥		
瀲	潋		
瀾	澜		
灃	沣		
灄	滠		
灋	法		
灑	洒		
灕	漓		
灘	滩		
灝	灏		
灣	湾		
灤	滦		
灩	滟		
災	灾		
為	为		
烏	乌		
烴	烃		
無	无		
煉	炼		
煒	炜		
煙	烟		
煢	茕		
煥	焕		
煩	烦		
煬	炀		
熅	煴		
熉	𤈶		
熒	荧		
熗	炝		
熰	𬉼		
熱	热		
熲	颎		
熾	炽		
燀	𬊤		
燁	烨		
燈	灯		
燉	炖		
燒	烧		
燖	𬊈		
燙	烫		
燜	焖		
營	营		
燦	灿		
燬	毁		
燭	烛		
燴	烩		
燶	㶶		
燻	熏		
燼	烬		
燾	焘		
爍	烁		
爐	炉		
爛	烂		
爭	争		
爲	为		
爺	爷		
爾	尔		
牆	墙		
牐	闸		
牘	牍		
牽	牵		
犖	荦		
犢	犊		
犧	牺		
狀	状		
狹	狭		
狽	狈		
猙	狰		
猶	犹		
猻	狲		
獁	犸		
獄	狱		
獅	狮		
獎	奖		
獘	毙		
獧	狷		
獨	独		
獪	狯		
獫	猃		
獮	狝		
獰	狞		
獲	获		
獵	猎		
獷	犷		
獸	兽		
獺	獭		
獻	献		
獼	猕		
玀	猡		
玁	𤞤		
玨	珏		
珮	佩		
現	现		
琍	璃		
琺	珐		
琿	珲		
瑋	玮		
瑣	琐		
瑤	瑶		
瑩	莹		
瑪	玛		
瑯	琅		
瑲	玱		
璉	琏		
璊	𫞩		
璡	琎		
璣	玑		
璦	瑷		
璫	珰		
璯	㻅		
環	环		
璵	玙		
璽	玺		
瓅	𬍛		
瓊	琼		
瓏	珑		
瓔	璎		
瓚	瓒		
甌	瓯		
甕	瓮		
產	产		
畝	亩		
畢	毕		
畫	画		
異	异		
當	当		
疇	畴		
疊	叠		
疎	疏		
疘	肛		
痙	痉		
痺	痹		
痾	疴		
瘂	痖		
瘋	疯		
瘍	疡		
瘓	痪		
瘞	瘗		
瘡	疮		
瘧	疟		
瘮	瘆		
瘲	疭		
瘻	瘘		
療	疗		
癆	痨		
癇	痫		
癈	废		
癉	瘅		
癐	𤶊		
癒	愈		
癘	疠		
癟	瘪		
癡	痴		
癢	痒		
癤	疖		
癥	症		
癧	疬		
癩	癞		
癬	癣		
癭	瘿		
癮	瘾		
癰	痈		
癱	瘫		
癲	癫		
發	发		
皐	皋		
皚	皑		
皜	皓		
皰	疱		
皸	皲		
皺	皱		
盃	杯		
盜	盗		
盞	盏		
盡	尽		
監	监		
盤	盘		
盧	卢		
盪	荡		
眎	视		
眥	眦		
眾	众		
睍	𪾢		
睏	困		
睜	睁		
睞	睐		
睠	眷		
瞇	眯		
瞘	眍		
瞜	䁖		
瞞	瞒		
瞤	𥆧		
瞼	睑		
矇	蒙		
矓	眬		
矚	瞩		
矯	矫		
砲	炮		
硃	朱		
硜	硁		
硤	硖		
硨	砗		
硯	砚		
碩	硕		
碭	砀		
碸	砜		
確	确		
碼	码		
磑	硙		
磚	砖		
磠	硵		
磣	碜		
磧	碛		
磯	矶		
磽	硗		
礄	硚		
礆	硷		
礎	础		
礐	𬒈		
礙	碍		
礡	礴		
礦	矿		
礪	砺		
礫	砾		
礬	矾		
礱	砻		
祿	禄		
禍	祸		
禎	祯		
禑	祦		
禕	祎		
禡	祃		
禦	御		
禪	禅		
禮	礼		
禰	祢		
禱	祷		
禿	秃		
秊	年		
秖	只		
稅	税		
稈	秆		
稜	棱		
稟	禀		
種	种		
稱	称		
穀	谷		
穇	䅟		
穌	稣		
積	积		
穎	颖		
穠	秾		
穡	穑		
穢	秽		
穩	稳		
穫	获		
穭	穞		
窩	窝		
窪	洼		
窮	穷		
窯	窑		
窵	窎		
窶	窭		
窺	窥		
竄	窜		
竅	窍		
竇	窦		
竈	灶		
竊	窃		
竚	伫		
競	竞		
筆	笔		
筍	笋		
筧	笕		
箋	笺		
箏	筝		
節	节		
範	范		
築	筑		
篋	箧		
篔	筼		
篘	𥬠		
篢	𬕂		
篤	笃		
篩	筛		
篳	筚		
簀	箦		
簍	篓		
簞	箪		
簡	简		
簣	篑		
簫	箫		
簷	檐		
簹	筜		
簽	签		
簾	帘		
籃	篮		
籅	𥫣		
籌	筹		
籔	䉤		
籙	箓		
籛	篯		
籜	箨		
籟	籁		
籠	笼		
籤	签		
籩	笾		
籪	簖		
籬	篱		
籮	箩		
籲	吁		
粵	粤		
粺	稗		
糝	糁		
糞	粪		
糧	粮		
糰	团		
糲	粝		
糴	籴		
糶	粜		
糹	纟		
糾	纠		
紀	纪		
紂	纣		
紃	𬘓		
約	约		
紅	红		
紆	纡		
紇	纥		
紈	纨		
紉	纫		
紋	纹		
納	纳		
紐	纽		
紓	纾		
純	纯		
紕	纰		
紗	纱		
紘	纮		
紙	纸		
級	级		
紛	纷		
紜	纭		
紝	纴		
紞	𬘘		
紡	纺		
紬	䌷		
紮	扎		
細	细		
紱	绂		
紲	绁		
紳	绅		
紵	纻		
紹	绍		
紺	绀		
紼	绋		
紿	绐		
絀	绌		
終	终		
組	组		
絅	䌹		
絆	绊		
絎	绗		
結	结		
絕	绝		
絛	绦		
絝	绔		
絞	绞		
絡	络		
絢	绚		
給	给		
絨	绒		
絪	𬘡		
絰	绖		
統	统		
絲	丝		
絳	绛		
絹	绢		
絺	𫄨		
綀	𦈌		
綁	绑		
綃	绡		
綆	绠		
綈	绨		
綌	绤		
綏	绥		
經	经		
綖	𫄧		
綜	综		
綝	𬘭		
綠	绿		
綢	绸		
綣	绻		
綪	𬘬		
綬	绶		
維	维		
綯	绹		
綰	绾		
綱	纲		
網	网		
綴	缀		
綵	䌽		
綸	纶		
綹	绺		
綺	绮		
綻	绽		
綽	绰		
綾	绫		
綿	绵		
緄	绲		
緇	缁		
緊	紧		
緋	绯		
緒	绪		
緔	绱		
緗	缃		
緘	缄		
緙	缂		
線	线		
緜	绵		
緝	缉		
緞	缎		
締	缔		
緡	缗		
緣	缘		
緦	缌		
編	编		
緩	缓		
緬	缅		
緯	纬		
緰	𦈕		
緱	缑		
緲	缈		
練	练		
緶	缏		
緹	缇		
緻	致		
縈	萦		
縉	缙		
縊	缢		
縋	缒		
縐	绉		
縑	缣		
縕	缊		
縗	缞		
縛	缚		
縝	缜		
縞	缟		
縟	缛		
縣	县		
縧	绦		
縫	缝		
縭	缡		
縮	缩		
縯	𬙂		
縱	纵		
縲	缧		
縳	䌸		
縴	纤		
縵	缦		
縶	絷		
縷	缕		
縹	缥		
總	总		
績	绩		
繃	绷		
繅	缫		
繆	缪		
繒	缯		
織	织		
繕	缮		
繖	伞		
繚	缭		
繞	绕		
繡	绣		
繢	缋		
繦	襁		
繩	绳		
繪	绘		
繫	系		
繭	茧		
繯	缳		
繰	缲		
繳	缴		
繸	䍁		
繹	绎		
繻	𦈡		
繼	继		
繽	缤		
繾	缱		
纁	𫄸		
纆	𬙊		
纇	颣		
纈	缬		
纊	纩		
續	续		
纍	累		
纏	缠		
纓	缨		
纔	才		
纕	𬙋		
纖	纤		
纘	缵		
纜	缆		
缽	钵		
罈	坛		
罌	罂		
罰	罚		
罵	骂		
罷	罢		
羅	罗		
羆	罴		
羈	羁		
羋	芈		
羥	羟		
義	义		
習	习		
翫	玩		
翬	翚		
翹	翘		
翽	翙		
耬	耧		
聖	圣		
聞	闻		
聰	聪		
聲	声		
聳	耸		
聵	聩		
聶	聂		
職	职		
聹	聍		
聽	听		
聾	聋		
肅	肃		
肈	肇		
脅	胁		
脈	脉		
脛	胫		
脣	唇		
脥	𣍰		
脫	脱		
脹	胀		
腎	肾		
腖	胨		
腡	脶		
腦	脑		
腫	肿		
腳	脚		
腸	肠		
膃	腽		
膕	腘		
膚	肤		
膠	胶		
膩	腻		
膽	胆		
膾	脍		
膿	脓		
臈	腊		
臉	脸		
臍	脐		
臏	膑		
臘	腊		
臚	胪		
臟	脏		
臠	脔		
臢	臜		
臥	卧		
臨	临		
臺	台		
與	与		
興	兴		
舉	举		
舊	旧		
舖	铺		
艙	舱		
艤	舣		
艦	舰		
艫	舻		
艱	艰		
艷	艳		
芻	刍		
荊	荆		
荍	荞		
莊	庄		
莖	茎		
莢	荚		
莧	苋		
菓	果		
菕	芲		
華	华		
萇	苌		
萊	莱		
萬	万		
萴	荝		
萵	莴		
葉	叶		
葒	荭		
葦	苇		
葯	药		
葷	荤		
蒓	莼		
蒔	莳		
蒞	莅		
蒼	苍		
蓀	荪		
蓆	席		
蓋	盖		
蓮	莲		
蓯	苁		
蓴	莼		
蓽	荜		
蔔	卜		
蔞	蒌		
蔣	蒋		
蔥	葱		
蔦	茑		
蔭	荫		
蔴	麻		
蕁	荨		
蕆	蒇		
蕎	荞		
蕒	荬		
蕓	芸		
蕕	莸		
蕘	荛		
蕢	蒉		
蕩	荡		
蕪	芜		
蕭	萧		
蕷	蓣		
薀	蕰		
薈	荟		
薊	蓟		
薌	芗		
薑	姜		
薔	蔷		
薘	荙		
薙	剃		
薦	荐		
薩	萨		
薴	苧		
薺	荠		
藍	蓝		
藎	荩		
藝	艺		
藥	药		
藪	薮		
藭	䓖		
藶	苈		
藹	蔼		
藺	蔺		
蘀	萚		
蘄	蕲		
蘆	芦		
蘇	苏		
蘊	蕴		
蘋	苹ǀ𬞟		
蘚	藓		
蘞	蔹		
蘢	茏		
蘤	花		
蘭	兰		
蘺	蓠		
蘿	萝		
虆	蔂		
虉	𬟁		
處	处		
虛	虚		
虜	虏		
號	号		
虧	亏		
虯	虬		
蛺	蛱		
蛻	蜕		
蜆	蚬		
蜺	霓		
蝀	𬟽		
蝕	蚀		
蝟	猬		
蝦	虾		
蝨	虱		
蝸	蜗		
螄	蛳		
螞	蚂		
螢	萤		
螮	䗖		
螻	蝼		
螿	螀		
蟄	蛰		
蟈	蝈		
蟎	螨		
蟣	虮		
蟬	蝉		
蟯	蛲		
蟲	虫		
蟶	蛏		
蟻	蚁		
蠁	蚃		
蠅	蝇		
蠆	虿		
蠍	蝎		
蠐	蛴		
蠑	蝾		
蠔	蚝		
蠙	𧏖		
蠟	蜡		
蠣	蛎		
蠨	蟏		
蠱	蛊		
蠶	蚕		
蠻	蛮		
衆	众		
衊	蔑		
術	术		
衕	同		
衛	卫		
衝	冲		
袞	衮		
袠	帙		
裊	袅		
裏	里		
補	补		
裝	装		
裡	里		
製	制		
複	复		
褌	裈		
褘	袆		
褲	裤		
褳	裢		
褸	褛		
褻	亵		
襇	裥		
襏	袯		
襖	袄		
襝	裣		
襠	裆		
襤	褴		
襪	袜		
襬	䙓		
襯	衬		
襲	袭		
襴	襕		
覈	核		
見	见		
覎	觃		
規	规		
覓	觅		
視	视		
覘	觇		
覡	觋		
覥	觍		
覦	觎		
親	亲		
覬	觊		
覯	觏		
覲	觐		
覷	觑		
覺	觉		
覽	览		
覿	觌		
觀	观		
觴	觞		
觶	觯		
觸	触		
訁	讠		
訂	订		
訃	讣		
計	计		
訊	讯		
訌	讧		
討	讨		
訏	𬣙		
訐	讦		
訒	讱		
訓	训		
訕	讪		
訖	讫		
託	托		
記	记		
訛	讹		
訝	讶		
訟	讼		
訢	䜣		
訣	诀		
訥	讷		
訪	访		
設	设		
許	许		
訴	诉		
訶	诃		
診	诊		
註	注		
証	证		
詀	𧮪		
詁	诂		
詆	诋		
詎	讵		
詐	诈		
詒	诒		
詔	诏		
評	评		
詖	诐		
詗	诇		
詘	诎		
詛	诅		
詞	词		
詠	咏		
詡	诩		
詢	询		
詣	诣		
試	试		
詩	诗		
詫	诧		
詬	诟		
詭	诡		
詮	诠		
詰	诘		
話	话		
該	该		
詳	详		
詵	诜		
詼	诙		
詿	诖		
誄	诔		
誅	诛		
誆	诓		
誇	夸		
誌	志		
認	认		
誑	诳		
誒	诶		
誕	诞		
誘	诱		
誚	诮		
語	语		
誠	诚		
誡	诫		
誣	诬		
誤	误		
誥	诰		
誦	诵		
誨	诲		
說	说		
説	说		
誰	谁		
課	课		
誶	谇		
誹	诽		
誼	谊		
誾	訚		
調	调		
諂	谄		
諄	谆		
談	谈		
諉	诿		
請	请		
諍	诤		
諏	诹		
諑	诼		
諒	谅		
論	论		
諗	谂		
諛	谀		
諜	谍		
諝	谞		
諞	谝		
諟	𬤊		
諠	喧		
諡	谥		
諢	诨		
諤	谔		
諦	谛		
諧	谐		
諫	谏		
諭	谕		
諮	谘		
諱	讳		
諳	谙		
諴	𫍯		
諶	谌		
諷	讽		
諸	诸		
諺	谚		
諼	谖		
諾	诺		
謀	谋		
謁	谒		
謂	谓		
謄	誊		
謅	诌		
謊	谎		
謎	谜		
謏	𫍲		
謐	谧		
謔	谑		
謖	谡		
謗	谤		
謙	谦		
謚	谥		
講	讲		
謝	谢		
謠	谣		
謨	谟		
謫	谪		
謬	谬		
謭	谫		
謳	讴		
謹	谨		
謾	谩		
譆	嘻		
證	证		
譎	谲		
譏	讥		
譖	谮		
識	识		
譙	谯		
譚	谭		
譜	谱		
譞	𫍽		
譫	谵		
譭	毁		
譯	译		
議	议		
譴	谴		
護	护		
譸	诪		
譽	誉		
讀	读		
讅	谉		
變	变		
讋	詟		
讌	宴ǀ䜩		
讎	雠		
讒	谗		
讓	让		
讕	谰		
讖	谶		
讙	欢		
讚	赞		
讜	谠		
讞	谳		
讟	𮙋		
豈	岂		
豎	竖		
豐	丰		
豔	艳		
豬	猪		
豶	豮		
貎	猊		
貓	猫		
貙	䝙		
貝	贝		
貞	贞		
負	负		
財	财		
貢	贡		
貧	贫		
貨	货		
販	贩		
貪	贪		
貫	贯		
責	责		
貯	贮		
貰	贳		
貲	赀		
貳	贰		
貴	贵		
貶	贬		
買	买		
貸	贷		
貺	贶		
費	费		
貼	贴		
貽	贻		
貿	贸		
賀	贺		
賁	贲		
賂	赂		
賃	赁		
賄	贿		
賅	赅		
資	资		
賈	贾		
賊	贼		
賑	赈		
賒	赊		
賓	宾		
賕	赇		
賙	赒		
賚	赉		
賜	赐		
賞	赏		
賠	赔		
賡	赓		
賢	贤		
賣	卖		
賤	贱		
賦	赋		
賧	赕		
質	质		
賫	赍		
賬	账		
賭	赌		
賴	赖		
賵	赗		
賺	赚		
賻	赙		
購	购		
賽	赛		
賾	赜		
贄	贽		
贅	赘		
贇	赟		
贈	赠		
贊	赞		
贍	赡		
贏	赢		
贐	赆		
贓	赃		
贔	赑		
贖	赎		
贗	赝		
贛	赣		
赬	赪		
趕	赶		
趙	赵		
趨	趋		
趲	趱		
跡	迹		
踐	践		
踴	踊		
蹌	跄		
蹔	暂		
蹕	跸		
蹟	迹		
蹣	蹒		
蹤	踪		
蹺	跷		
蹻	跷		
躂	跶		
躉	趸		
躊	踌		
躋	跻		
躍	跃		
躑	踯		
躒	跞		
躓	踬		
躕	蹰		
躘	𨀁		
躚	跹		
躝	𨅬		
躡	蹑		
躥	蹿		
躦	躜		
躪	躏		
軀	躯		
車	车		
軋	轧		
軌	轨		
軍	军		
軏	𫐄		
軒	轩		
軔	轫		
軛	轭		
軝	𬨂		
軟	软		
軫	轸		
軲	轱		
軸	轴		
軹	轵		
軺	轺		
軻	轲		
軼	轶		
軾	轼		
較	较		
輅	辂		
輇	辁		
輈	辀		
載	载		
輊	轾		
輒	辄		
輓	挽		
輔	辅		
輕	轻		
輗	𫐐		
輛	辆		
輜	辎		
輝	辉		
輞	辋		
輟	辍		
輥	辊		
輦	辇		
輩	辈		
輪	轮		
輬	辌		
輮	𫐓		
輯	辑		
輳	辏		
輶	𬨎		
輸	输		
輻	辐		
輾	辗		
輿	舆		
轀	辒		
轂	毂		
轄	辖		
轅	辕		
轆	辘		
轉	转		
轍	辙		
轎	轿		
轔	辚		
轟	轰		
轡	辔		
轢	轹		
轤	轳		
辦	办		
辭	辞		
辮	辫		
辯	辩		
農	农		
迴	回		
逕	迳		
這	这		
連	连		
週	周		
進	进		
遊	游		
運	运		
過	过		
達	达		
違	违		
遙	遥		
遜	逊		
遞	递		
遠	远		
適	适		
遲	迟		
遶	绕		
遷	迁		
選	选		
遺	遗		
遼	辽		
邁	迈		
還	还		
邇	迩		
邊	边		
邏	逻		
邐	逦		
郟	郏		
郵	邮		
鄆	郓		
鄉	乡		
鄒	邹		
鄔	邬		
鄖	郧		
鄧	邓		
鄩	𬩽		
鄭	郑		
鄰	邻		
鄲	郸		
鄴	邺		
鄶	郐		
鄺	邝		
酇	酂		
酈	郦		
醃	腌		
醜	丑		
醞	酝		
醫	医		
醬	酱		
醱	酦		
醲	𬪩		
釀	酿		
釁	衅		
釃	酾		
釅	酽		
釋	释		
釓	钆		
釔	钇		
釕	钌		
釗	钊		
釘	钉		
釙	钋		
針	针		
釣	钓		
釤	钐		
釦	扣		
釧	钏		
釩	钒		
釳	𨰿		
釵	钗		
釷	钍		
釹	钕		
釺	钎		
鈀	钯		
鈁	钫		
鈃	钘		
鈄	钭		
鈇	𫓧		
鈈	钚		
鈉	钠		
鈍	钝		
鈎	钩		
鈐	钤		
鈑	钣		
鈒	钑		
鈔	钞		
鈕	钮		
鈞	钧		
鈣	钙		
鈥	钬		
鈦	钛		
鈧	钪		
鈮	铌		
鈰	铈		
鈳	钶		
鈴	铃		
鈷	钴		
鈸	钹		
鈹	铍		
鈺	钰		
鈽	钸		
鈾	铀		
鈿	钿		
鉀	钾		
鉅	钜		
鉈	铊		
鉉	铉		
鉊	𬬿		
鉋	铇		
鉍	铋		
鉑	铂		
鉕	钷		
鉗	钳		
鉚	铆		
鉛	铅		
鉝	𫟷		
鉞	钺		
鉤	钩		
鉥	𬬸		
鉦	钲		
鉧	𬭁		
鉬	钼		
鉭	钽		
鉸	铰		
鉺	铒		
鉻	铬		
鉿	铪		
銀	银		
銃	铳		
銅	铜		
銍	铚		
銑	铣		
銓	铨		
銖	铢		
銘	铭		
銚	铫		
銛	铦		
銜	衔		
銠	铑		
銣	铷		
銥	铱		
銦	铟		
銨	铵		
銩	铥		
銪	铕		
銫	铯		
銬	铐		
銱	铞		
銳	锐		
銶	𨱇		
銷	销		
銹	锈		
銻	锑		
銼	锉		
銾	汞		
鋁	铝		
鋃	锒		
鋅	锌		
鋇	钡		
鋌	铤		
鋏	铗		
鋐	𬭎		
鋒	锋		
鋙	铻		
鋝	锊		
鋟	锓		
鋤	锄		
鋥	锃		
鋦	锔		
鋨	锇		
鋩	铓		
鋪	铺		
鋮	铖		
鋯	锆		
鋰	锂		
鋱	铽		
鋸	锯		
鋹	𬬮		
鋼	钢		
錀	𬬭		
錁	锞		
錄	录		
錆	锖		
錇	锫		
錈	锩		
錏	铔		
錐	锥		
錒	锕		
錕	锟		
錘	锤		
錙	锱		
錚	铮		
錛	锛		
錞	𬭚		
錟	锬		
錠	锭		
錡	锜		
錢	钱		
錤	𫓹		
錦	锦		
錨	锚		
錩	锠		
錫	锡		
錮	锢		
錯	错		
錳	锰		
錶	表		
錸	铼		
鍀	锝		
鍁	锨		
鍃	锪		
鍆	钔		
鍇	锴		
鍈	锳		
鍊	炼		
鍋	锅		
鍍	镀		
鍔	锷		
鍘	铡		
鍚	钖		
鍛	锻		
鍠	锽		
鍤	锸		
鍥	锲		
鍩	锘		
鍬	锹		
鍭	𬭤		
鍰	锾		
鍵	键		
鍶	锶		
鍺	锗		
鍾	钟ǀ锺		
鎂	镁		
鎄	锿		
鎇	镅		
鎊	镑		
鎓	𬭩		
鎔	镕		
鎖	锁		
鎗	枪		
鎘	镉		
鎛	镈		
鎝	𨱏		
鎡	镃		
鎢	钨		
鎣	蓥		
鎦	镏		
鎧	铠		
鎩	铩		
鎪	锼		
鎬	镐		
鎮	镇		
鎯	𨱍		
鎰	镒		
鎳	镍		
鎵	镓		
鎶	鿔		
鎿	镎		
鏃	镞		
鏇	旋ǀ镟		
鏈	链		
鏌	镆		
鏐	镠		
鏑	镝		
鏗	铿		
鏘	锵		
鏜	镗		
鏝	镘		
鏞	镛		
鏟	铲		
鏡	镜		
鏢	镖		
鏤	镂		
鏨	錾		
鏰	镚		
鏵	铧		
鏷	镤		
鏹	镪		
鏻	𬭸		
鐃	铙		
鐄	𨱑		
鐇	𫔍		
鐏	𨱔		
鐐	镣		
鐒	铹		
鐓	镦		
鐔	镡		
鐘	钟		
鐙	镫		
鐝	镢		
鐠	镨		
鐦	锎		
鐧	锏		
鐨	镄		
鐩	𬭼		
鐫	镌		
鐮	镰		
鐱	钎		
鐲	镯		
鐳	镭		
鐵	铁		
鐶	镮		
鐸	铎		
鐺	铛		
鐽	𫟼		
鐿	镱		
鑄	铸		
鑊	镬		
鑌	镔		
鑑	鉴		
鑒	鉴		
鑔	镲		
鑕	锧		
鑞	镴		
鑠	铄		
鑣	镳		
鑥	镥		
鑪	𬬻		
鑭	镧		
鑰	钥		
鑱	镵		
鑲	镶		
鑷	镊		
鑹	镩		
鑼	锣		
鑽	钻		
鑾	銮		
鑿	凿		
钁	䦆		
钂	镋		
長	长		
門	门		
閂	闩		
閃	闪		
閆	闫		
閈	闬		
閉	闭		
開	开		
閌	闶		
閎	闳		
閏	闰		
閑	闲		
間	间		
閔	闵		
閘	闸		
閡	阂		
閣	阁		
閤	𬮤		
閥	阀		
閨	闺		
閩	闽		
閫	阃		
閬	阆		
閭	闾		
閱	阅		
閶	阊		
閹	阉		
閻	阎		
閼	阏		
閽	阍		
閾	阈		
閿	阌		
闃	阒		
闆	板		
闇	暗		
闈	闱		
闉	𬮱		
闊	阔		
闋	阕		
闌	阑		
闍	阇		
闐	阗		
闑	𫔶		
闒	阘		
闓	闿		
闔	阖		
闕	阙		
闖	闯		
關	关		
闞	阚		
闠	阓		
闡	阐		
闢	辟		
闤	阛		
闥	闼		
阬	坑		
阯	址		
陘	陉		
陝	陕		
陣	阵		
陰	阴		
陳	陈		
陸	陆		
陻	堙		
陽	阳		
隄	堤		
隉	陧		
隊	队		
階	阶		
隕	陨		
際	际		
隤	𬯎		
隨	随		
險	险		
隮	𬯀		
隱	隐		
隴	陇		
隸	隶		
隻	只		
雋	隽		
雖	虽		
雙	双		
雛	雏		
雜	杂		
雞	鸡		
離	离		
難	难		
雲	云		
電	电		
霑	沾		
霧	雾		
霽	霁		
靂	雳		
靄	霭		
靆	叇		
靈	灵		
靉	叆		
靚	靓		
靜	静		
靦	腼ǀ䩄		
靨	靥		
鞀	鼗		
鞏	巩		
鞦	秋		
韁	缰		
韃	鞑		
韆	千		
韉	鞯		
韋	韦		
韌	韧		
韍	韨		
韓	韩		
韙	韪		
韜	韬		
韞	韫		
韻	韵		
響	响		
頁	页		
頂	顶		
頃	顷		
項	项		
順	顺		
頇	顸		
須	须		
頊	顼		
頌	颂		
頍	𫠆		
頎	颀		
頏	颃		
預	预		
頑	顽		
頒	颁		
頓	顿		
頔	𬱖		
頗	颇		
領	领		
頜	颌		
頠	𬱟		
頡	颉		
頤	颐		
頦	颏		
頫	𫖯		
頭	头		
頰	颊		
頲	颋		
頷	颔		
頸	颈		
頹	颓		
頻	频		
顆	颗		
題	题		
額	额		
顎	颚		
顏	颜		
顒	颙		
顓	颛		
顗	𫖮		
願	愿		
顙	颡		
顛	颠		
類	类		
顢	颟		
顥	颢		
顧	顾		
顫	颤		
顬	颥		
顯	显		
顰	颦		
顱	颅		
顳	颞		
顴	颧		
風	风		
颭	飐		
颮	飑		
颯	飒		
颱	台		
颳	刮		
颶	飓		
颸	飔		
颺	飏		
颻	飖		
颼	飕		
颾	𩙫		
颿	帆		
飀	飗		
飄	飘		
飆	飙		
飈	飚		
飛	飞		
飠	饣		
飢	饥		
飣	饤		
飥	饦		
飩	饨		
飪	饪		
飫	饫		
飭	饬		
飯	饭		
飲	饮		
飴	饴		
飼	饲		
飽	饱		
飾	饰		
餃	饺		
餄	饸		
餅	饼		
餉	饷		
養	养		
餌	饵		
餎	饹		
餑	饽		
餒	馁		
餓	饿		
餔	哺		
餕	馂		
餖	饾		
餗	𫗧		
餘	余ǀ馀		
餚	肴		
餛	馄		
餜	馃		
餞	饯		
餡	馅		
館	馆		
餬	糊		
餱	糇		
餳	饧		
餵	喂		
餸	𩠌		
餺	馎		
餼	饩		
餽	馈		
餾	馏		
餿	馊		
饁	馌		
饃	馍		
饅	馒		
饈	馐		
饉	馑		
饊	馓		
饋	馈		
饌	馔		
饑	饥		
饒	饶		
饗	飨		
饘	𫗴		
饜	餍		
饞	馋		
饢	馕		
馬	马		
馭	驭		
馮	冯		
馱	驮		
馳	驰		
馴	驯		
馹	驲		
駁	驳		
駃	𫘝		
駉	𬳶		
駐	驻		
駑	驽		
駒	驹		
駓	𬳵		
駔	驵		
駕	驾		
駘	骀		
駙	驸		
駛	驶		
駝	驼		
駟	驷		
駢	骈		
駪	𬳽		
駭	骇		
駮	驳		
駰	骃		
駱	骆		
駸	骎		
駿	骏		
騁	骋		
騂	骍		
騄	𫘧		
騅	骓		
騌	骔		
騍	骒		
騎	骑		
騏	骐		
騖	骛		
騙	骗		
騠	𫘨		
騤	骙		
騧	䯄		
騫	骞		
騭	骘		
騮	骝		
騰	腾		
騵	𫘪		
騶	驺		
騷	骚		
騸	骟		
騾	骡		
驀	蓦		
驁	骜		
驂	骖		
驃	骠		
驄	骢		
驅	驱		
驊	骅		
驌	骕		
驍	骁		
驎	麟ǀ𬴊		
驏	骣		
驕	骄		
驗	验		
驚	惊		
驛	驿		
驟	骤		
驢	驴		
驤	骧		
驥	骥		
驦	骦		
驩	欢		
驪	骊		
驫	骉		
骯	肮		
骽	腿		
骾	鲠		
髏	髅		
髐	髇		
髒	脏		
體	体		
髕	髌		
髖	髋		
髮	发		
髴	佛		
鬆	松		
鬉	鬃		
鬍	胡		
鬚	须		
鬢	鬓		
鬥	斗		
鬧	闹		
鬨	哄		
鬩	阋		
鬭	斗		
鬮	阄		
鬱	郁		
魎	魉		
魘	魇		
魚	鱼		
魛	鱽		
魟	𫚉		
魨	鲀		
魯	鲁		
魴	鲂		
魷	鱿		
鮀	𬶍		
鮁	鲅		
鮃	鲆		
鮆	𫚖		
鮍	鲏		
鮎	鲇		
鮐	鲐		
鮑	鲍		
鮒	鲋		
鮓	鲊		
鮚	鲒		
鮜	鲘		
鮞	鲕		
鮟	𩽾		
鮠	𬶏		
鮣	䲟		
鮦	鲖		
鮪	鲔		
鮫	鲛		
鮭	鲑		
鮮	鲜		
鮶	鲪		
鮸	𩾃		
鮺	鲝		
鯀	鲧		
鯁	鲠		
鯄	𩾁		
鯇	鲩		
鯉	鲤		
鯊	鲨		
鯔	鲻		
鯕	鲯		
鯖	鲭		
鯗	鲞		
鯛	鲷		
鯝	鲴		
鯡	鲱		
鯢	鲵		
鯤	鲲		
鯧	鲳		
鯨	鲸		
鯪	鲮		
鯫	鲰		
鯰	鲶		
鯷	鳀		
鯽	鲫		
鯿	鳊		
鰂	鲗		
鰆	䲠		
鰈	鲽		
鰉	鳇		
鰍	鳅		
鰏	鲾		
鰒	鳆		
鰓	鳃		
鰜	鳒		
鰟	鳑		
鰣	鲥		
鰤	𫚕		
鰥	鳏		
鰨	鳎		
鰩	鳐		
鰭	鳍		
鰮	鳁		
鰱	鲢		
鰲	鳌		
鰳	鳓		
鰶	𬶭		
鰷	鲦		
鰹	鲣		
鰺	鲹		
鰻	鳗		
鰼	鳛		
鰾	鳔		
鱀	𬶨		
鱅	鳙		
鱇	𩾌		
鱈	鳕		
鱉	鳖		
鱒	鳟		
鱔	鳝		
鱖	鳜		
鱗	鳞		
鱘	鲟		
鱝	鲼		
鱟	鲎		
鱠	鲙		
鱣	鳣		
鱤	鳡		
鱧	鳢		
鱨	鲿		
鱭	鲚		
鱯	鳠		
鱲	𫚭		
鱷	鳄		
鱸	鲈		
鱺	鲡		
鱻	鲜		
鳥	鸟		
鳧	凫		
鳩	鸠		
鳲	鸤		
鳳	凤		
鳴	鸣		
鳶	鸢		
鳾	䴓		
鴆	鸩		
鴇	鸨		
鴉	鸦		
鴒	鸰		
鴕	鸵		
鴛	鸳		
鴜	𪉈		
鴝	鸲		
鴞	鸮		
鴟	鸱		
鴣	鸪		
鴦	鸯		
鴨	鸭		
鴯	鸸		
鴰	鸹		
鴴	鸻		
鴷	䴕		
鴻	鸿		
鴿	鸽		
鵁	䴔		
鵂	鸺		
鵐	鹀		
鵑	鹃		
鵒	鹆		
鵓	鹁		
鵜	鹈		
鵝	鹅		
鵠	鹄		
鵡	鹉		
鵪	鹌		
鵬	鹏		
鵮	鹐		
鵯	鹎		
鵰	雕		
鵲	鹊		
鵷	鹓		
鵾	鹍		
鶇	鸫		
鶉	鹑		
鶊	鹒		
鶓	鹋		
鶖	鹙		
鶘	鹕		
鶚	鹗		
鶡	鹖		
鶥	鹛		
鶩	鹜		
鶪	䴗		
鶬	鸧		
鶯	莺		
鶱	𬸣		
鶲	鹟		
鶴	鹤		
鶹	鹠		
鶺	鹡		
鶻	鹘		
鶼	鹣		
鶿	鹚		
鷁	鹢		
鷂	鹞		
鷈	䴘		
鷓	鹧		
鷖	鹥		
鷗	鸥		
鷙	鸷		
鷚	鹨		
鷟	𬸦		
鷥	鸶		
鷦	鹪		
鷫	鹔		
鷭	𬸪		
鷯	鹩		
鷲	鹫		
鷳	鹇		
鷴	鹇		
鷸	鹬		
鷹	鹰		
鷺	鹭		
鷽	鸴		
鷿	䴙		
鸂	㶉		
鸇	鹯		
鸌	鹱		
鸏	鹲		
鸑	𬸚		
鸕	鸬		
鸘	鹴		
鸚	鹦		
鸛	鹳		
鸝	鹂		
鸞	鸾		
鹵	卤		
鹹	咸		
鹺	鹾		
鹼	碱		
鹽	盐		
麗	丽		
麤	粗		
麥	麦		
麩	麸		
麵	面		
麼	么ǀ麽		
黃	黄		
黌	黉		
點	点		
黨	党		
黲	黪		
黴	霉		
黶	黡		
黷	黩		
黽	黾		
黿	鼋		
鼉	鼍		
鼕	冬		
鼴	鼹		
齊	齐		
齋	斋		
齎	赍		
齏	齑		
齒	齿		
齔	龀		
齕	龁		
齙	龅		
齜	龇		
齟	龃		
齠	龆		
齡	龄		
齦	龈		
齪	龊		
齬	龉		
齮	𬺈		
齯	𫠜		
齲	龋		
齶	腭		
齷	龌		
龍	龙		
龎	厐		
龐	庞		
龑	䶮		
龔	龚		
龕	龛		
龜	龟		
𨧀	𬭊		
𨨏	𬭛		
𨭆	𬭶		
𨭎	𬭳		
𩧢	𱅒		
𰻞	𰻝		
上昇	上升		
下單	下单		
不單	不单		
不著	不着		
並聯	并联		
串聯	串联		
久別	久别		
么二	幺二		
么點	幺点		
乾俸	干俸		
乾兒	干儿		
乾冰	干冰		
乾嘔	干呕		
乾噦	干哕		
乾嚎	干嚎		
乾娘	干娘		
乾媽	干妈		
乾屍	干尸		
乾旱	干旱		
乾杯	干杯		
乾果	干果		
乾枯	干枯		
乾洗	干洗		
乾涸	干涸		
乾淨	干净		
乾渴	干渴		
乾潮	干潮		
乾澀	干涩		
乾煸	干煸		
乾燥	干燥		
乾爹	干爹		
乾爽	干爽		
乾瘦	干瘦		
乾癟	干瘪		
乾癬	干癣		
乾笑	干笑		
乾等	干等		
乾粉	干粉		
乾糧	干粮		
乾脆	干脆		
乾草	干草		
乾菜	干菜		
乾葉	干叶		
乾薑	干姜		
乾號	干号		
乾衣	干衣		
乾裂	干裂		
乾貝	干贝		
乾貨	干货		
乾透	干透		
乾酪	干酪		
乾飯	干饭		
乾餾	干馏		
互聯	互联		
介於	介于		
代勞	代劳		
休閒	休闲		
伯勞	伯劳		
位於	位于		
作別	作别		
來著	来着		
依著	依着		
便於	便于		
保單	保单		
個別	个别		
倒著	倒着		
借單	借单		
偏勞	偏劳		
偷閒	偷闲		
傢俱	家俱		
傳單	传单		
傷別	伤别		
傾羨	倾羡		
優於	优于		
光著	光着		
免於	免于		
入聯	入联		
公釐	公厘		
冒著	冒着		
出於	出于		
分別	分别		
判別	判别		
別人	别人		
別傳	别传		
別克	别克		
別具	别具		
別名	别名		
別墅	别墅		
別子	别子		
別字	别字		
別有	别有		
別樣	别样		
別無	别无		
別理	别理		
別的	别的		
別看	别看		
別稱	别称		
別筵	别筵		
別管	别管		
別緒	别绪		
別緻	别致		
別臉	别脸		
別莊	别庄		
別處	别处		
別號	别号		
別說	别说		
別論	别论		
別針	别针		
別離	别离		
利於	利于		
利茲	利兹		
刷單	刷单		
剋扣	克扣		
剋星	克星		
功勞	功劳		
勇於	勇于		
勞作	劳作		
勞倦	劳倦		
勞傷	劳伤		
勞力	劳力		
勞動	劳动		
勞務	劳务		
勞工	劳工		
勞役	劳役		
勞心	劳心		
勞損	劳损		
勞改	劳改		
勞教	劳教		
勞方	劳方		
勞模	劳模		
勞煩	劳烦		
勞碌	劳碌		
勞神	劳神		
勞累	劳累		
勞苦	劳苦		
勞資	劳资		
勞逸	劳逸		
勞雇	劳雇		
勞頓	劳顿		
勞駕	劳驾		
勤勞	勤劳		
勾聯	勾联		
包乾	包干		
區別	区别		
反覆	反复		
各別	各别		
合於	合于		
合著	合着ǀ合著		
名單	名单		
向著	向着		
吸著	吸着		
吹乾	吹干		
吻別	吻别		
告別	告别		
咬齧	咬啮		
唁勞	唁劳		
善於	善于		
單一	单一		
單于	单于		
單人	单人		
單位	单位		
單個	单个		
單側	单侧		
單傳	单传		
單價	单价		
單元	单元		
單兵	单兵		
單叢	单丛		
單句	单句		
單另	单另		
單向	单向		
單單	单单		
單團	单团		
單套	单套		
單子	单子		
單字	单字		
單射	单射		
單層	单层		
單幹	单干		
單張	单张		
單意	单意		
單戀	单恋		
單手	单手		
單打	单打		
單挑	单挑		
單擊	单击		
單據	单据		
單擺	单摆		
單數	单数		
單方	单方		
單日	单日		
單晶	单晶		
單曲	单曲		
單月	单月		
單極	单极		
單槓	单杠		
單樅	单枞		
單模	单模		
單獨	单独		
單瓣	单瓣		
單產	单产		
單用	单用		
單盲	单盲		
單相	单相		
單眼	单眼		
單程	单程		
單穩	单稳		
單糖	单糖		
單純	单纯		
單縣	单县		
單色	单色		
單薄	单薄		
單號	单号		
單行	单行		
單衣	单衣		
單褲	单裤		
單親	单亲		
單詞	单词		
單語	单语		
單調	单调		
單證	单证		
單質	单质		
單趟	单趟		
單身	单身		
單車	单车		
單軌	单轨		
單過	单过		
單邊	单边		
單鉻	单铬		
單鍵	单键		
單鏈	单链		
單非	单非		
單鞋	单鞋		
單項	单项		
單體	单体		
單點	单点		
嗔著	嗔着		
噁嗪	恶嗪		
回單	回单		
國聯	国联		
在於	在于		
埋單	埋单		
執著	执着		
基於	基于		
報單	报单		
外勞	外劳		
多於	多于		
大於	大于		
大鵟	大𫛭		
失單	失单		
失聯	失联		
失著	失着		
夾克	夹克		
夾具	夹具		
夾子	夹子		
夾層	夹层		
夾帶	夹带		
夾心	夹心		
夾批	夹批		
夾持	夹持		
夾擊	夹击		
夾攻	夹攻		
夾斷	夹断		
夾板	夹板		
夾棍	夹棍		
夾江	夹江		
夾生	夹生		
夾當	夹当		
夾盤	夹盘		
夾緊	夹紧		
夾縫	夹缝		
夾襖	夹袄		
夾角	夹角		
夾道	夹道		
夾鉗	夹钳		
夾雜	夹杂		
夾餡	夹馅		
奇羨	奇羡		
奏摺	奏折		
奧祕	奥秘		
女單	女单		
婦聯	妇联		
存摺	存折		
孤單	孤单		
安於	安于		
安聯	安联		
安閒	安闲		
定單	定单		
定於	定于		
宜於	宜于		
對么	对幺		
對摺	对折		
對於	对于		
對聯	对联		
小於	小于		
就著	就着		
屬於	属于		
左聯	左联		
差別	差别		
帕勞	帕劳		
帳單	帐单		
幣別	币别		
床單	床单		
引別	引别		
引徵	引征		
引著	引着		
強徵	强征		
彈夾	弹夹		
彷彿	仿佛		
徒勞	徒劳		
得著	得着		
復甦	复苏		
復聯	复联		
循著	循着		
徵信	征信		
徵候	征候		
徵傳	征传		
徵兆	征兆		
徵兵	征兵		
徵募	征募		
徵友	征友		
徵召	征召		
徵士	征士		
徵婚	征婚		
徵實	征实		
徵才	征才		
徵收	征收		
徵文	征文		
徵求	征求		
徵狀	征状		
徵發	征发		
徵稅	征税		
徵稿	征稿		
徵聘	征聘		
徵詢	征询		
徵調	征调		
徵象	征象		
徵選	征选		
徵集	征集		
心摺	心折		
心羨	心羡		
忌羨	忌羡		
忙於	忙于		
忙著	忙着		
忠於	忠于		
急於	急于		
急著	急着		
性別	性别		
性徵	性征		
怪祕	怪秘		
悠著	悠着		
悠閒	悠闲		
惜別	惜别		
慰勞	慰劳		
憑單	凭单		
憑著	凭着		
應徵	应征		
房勞	房劳		
扶馀	扶余		
找著	找着		
拜別	拜别		
指徵	指征		
挨著	挨着		
捱延	挨延		
探祕	探秘		
接單	接单		
接著	接着		
提單	提单		
提昇	提升		
換單	换单		
握別	握别		
揮別	挥别		
摀住	捂住		
摺光	折光		
摺奏	折奏		
摺子	折子		
摺尺	折尺		
摺椅	折椅		
摺紙	折纸		
摺裙	折裙		
摺轉	折转		
操勞	操劳		
擦乾	擦干		
效勞	效劳		
敢於	敢于		
文聯	文联		
斫畬	斫畲		
於是	于是		
於焉	于焉		
於田	于田		
於都	于都		
昇值	升值		
昇空	升空		
昇調	升调		
昇降	升降		
昇高	升高		
明瞭	明了		
易於	易于		
春聯	春联		
晾乾	晾干		
曬乾	晒干		
書劄	书札		
曼聯	曼联		
有別	有别		
有勞	有劳		
有著	有着		
朝著	朝着		
本著	本着		
枉勞	枉劳		
枯乾	枯干		
棧單	栈单		
楹聯	楹联		
榜單	榜单		
樂於	乐于		
樣單	样单		
次於	次于		
欽羨	钦羡		
正著	正着		
歸於	归于		
死別	死别		
永別	永别		
汙垢	污垢		
江乾	江干		
沉著	沉着		
沿著	沿着		
活著	活着		
派別	派别		
流乾	流干		
流別	流别		
流於	流于		
浮著	浮着		
消閒	消闲		
淩虐	凌虐		
清單	清单		
清閒	清闲		
源於	源于		
瀕於	濒于		
為著	为着		
烘乾	烘干		
焙乾	焙干		
無著	无着		
煩勞	烦劳		
特別	特别		
特徵	特征		
牽聯	牵联		
犒勞	犒劳		
猜著	猜着		
瑯琊	琅玡		
甄別	甄别		
甘於	甘于		
甦仙	苏仙		
甦醒	苏醒		
由於	由于		
由著	由着		
男單	男单		
界別	界别		
留別	留别		
畢昇	毕升		
畢茲	毕兹		
畬族	畲族		
畬鄉	畲乡		
當著	当着		
疏於	疏于		
疲勞	疲劳		
病徵	病征		
痴獃	痴呆		
白朮	白术		
皮夾	皮夹		
相聯	相联		
盼覆	盼复		
睡著	睡着		
瞭然	了然		
瞭解	了解		
示覆	示复		
祕傳	秘传		
祕方	秘方		
祕本	秘本		
祕結	秘结		
祕藏	秘藏		
秤槃	秤盘		
空閒	空闲		
穿著	穿着		
等於	等于		
等閒	等闲		
答覆	答复		
簡單	简单		
精於	精于		
紙夾	纸夹		
級別	级别		
級聯	级联		
終於	终于		
結單	结单		
綿聯	绵联		
緑教	绿教		
緣於	缘于		
緩徵	缓征		
纏夾	缠夹		
罰單	罚单		
羅茲	罗兹		
美勞	美劳		
羨慕	羡慕		
老么	老幺		
耐勞	耐劳		
聯俄	联俄		
聯保	联保		
聯合	联合		
聯名	联名		
聯大	联大		
聯姻	联姻		
聯宗	联宗		
聯想	联想		
聯手	联手		
聯接	联接		
聯播	联播		
聯星	联星		
聯機	联机		
聯歡	联欢		
聯氨	联氨		
聯營	联营		
聯產	联产		
聯盟	联盟		
聯結	联结		
聯絡	联络		
聯網	联网		
聯綴	联缀		
聯綿	联绵		
聯繫	联系		
聯署	联署		
聯翩	联翩		
聯考	联考		
聯航	联航		
聯號	联号		
聯袂	联袂		
聯誦	联诵		
聯誼	联谊		
聯貫	联贯		
聯賽	联赛		
聯軍	联军		
聯通	联通		
聯運	联运		
聯邦	联邦		
聯隊	联队		
聯集	联集		
背著	背着		
脫單	脱单		
膠著	胶着		
臨別	临别		
至於	至于		
艷羨	艳羡		
花著	花着		
苦勞	苦劳		
苦於	苦于		
苧麻	苎麻		
茲因	兹因		
茶鏽	茶锈		
菜單	菜单		
落單	落单		
著力	着力		
著呢	着呢		
著地	着地		
著墨	着墨		
著實	着实		
著床	着床		
著忙	着忙		
著急	着急		
著惱	着恼		
著想	着想		
著意	着意		
著慌	着慌		
著手	着手		
著數	着数		
著棋	着棋		
著法	着法		
著涼	着凉		
著火	着火		
著然	着然		
著眼	着眼		
著筆	着笔		
著緊	着紧		
著色	着色		
著花	着花		
著落	着落		
著處	着处		
著衣	着衣		
著裝	着装		
著迷	着迷		
著邊	着边		
著重	着重		
著陸	着陆		
著魔	着魔		
蓋茲	盖兹		
薰心	熏心		
薰陶	熏陶		
藉此	借此		
藉著	藉着		
蘇聯	苏联		
處於	处于		
蝦乾	虾干		
蟬聯	蝉联		
衣夾	衣夹		
衣著	衣着		
表單	表单		
表徵	表征		
被單	被单		
西單	西单		
要著	要着ǀ要著		
覆迭	复迭		
訂單	订单		
訣別	诀别		
試著	试着		
詭祕	诡秘		
話別	话别		
識別	识别		
護著	护着		
象徵	象征		
買單	买单		
賢勞	贤劳		
賦閒	赋闲		
賬單	账单		
赫茲	赫兹		
超聯	超联		
趨於	趋于		
跟著	跟着		
身著	身着		
輓聯	挽联		
辛勞	辛劳		
辨別	辨别		
辭別	辞别		
辯別	辩别		
迫於	迫于		
送別	送别		
運單	运单		
過勞	过劳		
過於	过于		
道別	道别		
違別	违别		
遠勞	远劳		
選單	选单		
邦聯	邦联		
郵摺	邮折		
酒單	酒单		
酒麴	酒曲		
酬勞	酬劳		
重聯	重联		
釐克	厘克		
釐升	厘升		
釐析	厘析		
釐清	厘清		
釐米	厘米		
金晟	金成		
銀聯	银联		
錢夾	钱夹		
鏽斑	锈斑		
鏽鐵	锈铁		
鐵鏽	铁锈		
鑑別	鉴别		
鑒於	鉴于		
長於	长于		
門聯	门联		
閉著	闭着		
開單	开单		
開徵	开征		
閒事	闲事		
閒人	闲人		
閒侃	闲侃		
閒口	闲口		
閒情	闲情		
閒扯	闲扯		
閒晃	闲晃		
閒暇	闲暇		
閒書	闲书		
閒混	闲混		
閒空	闲空		
閒置	闲置		
閒聊	闲聊		
閒話	闲话		
閒談	闲谈		
閒適	闲适		
闊別	阔别		
關於	关于		
關聯	关联		
防夾	防夹		
附著	附着		
限於	限于		
陰乾	阴干		
陷於	陷于		
陸勞	陆劳		
隨著	随着		
離別	离别		
順著	顺着		
頷聯	颔联		
類別	类别		
風乾	风干		
飛昇	飞升		
餅乾	饼干		
餞別	饯别		
香乾	香干		
馬伕	马夫		
驚羨	惊羡		
體徵	体征		
高於	高于		
髮夾	发夹		
魏徵	魏征		
麻苧	麻苎		
黏著	黏着		
黑産	黑产		
龐茲	庞兹		
龜茲	龟兹		
三聯管	三联管		
不亞於	不亚于		
不鏽鋼	不锈钢		
中聯辦	中联办		
么並矢	幺并矢		
乾女兒	干女儿		
乾巴巴	干巴巴		
乾打壘	干打垒		
乾梅子	干梅子		
乾物女	干物女		
乾眼症	干眼症		
乾瞪眼	干瞪眼		
乾著急	干着急		
亞足聯	亚足联		
交款單	交款单		
以致於	以致于		
保險單	保险单		
借書單	借书单		
停損單	停损单		
傑佛茲	杰佛兹		
傾向於	倾向于		
克勞德	克劳德		
克勞斯	克劳斯		
兩著兒	两着儿		
凸摺線	凸折线		
別動隊	别动队		
別客氣	别客气		
別提了	别提了		
別苗頭	别苗头		
別著急	别着急		
加茲尼	加兹尼		
勞什子	劳什子		
勞倫斯	劳伦斯		
勞埃德	劳埃德		
勞委會	劳委会		
匹茲堡	匹兹堡		
卓別林	卓别林		
取決於	取决于		
吃閒飯	吃闲饭		
哈囉德	哈罗德		
喜山鵟	喜山𫛭		
單倍體	单倍体		
單反機	单反机		
單味藥	单味药		
單寧酸	单宁酸		
單峰駝	单峰驼		
單房差	单房差		
單放機	单放机		
單板機	单板机		
單源論	单源论		
單片機	单片机		
單班課	单班课		
單簧管	单簧管		
單細胞	单细胞		
單肩包	单肩包		
單胞藻	单胞藻		
單腳跳	单脚跳		
單輪車	单轮车		
單速車	单速车		
單間差	单间差		
單院制	单院制		
單音節	单音节		
單音詞	单音词		
單韻母	单韵母		
嘟著嘴	嘟着嘴		
回執單	回执单		
圖盧茲	图卢兹		
地積單	地积单		
培勒茲	培勒兹		
基布茲	基布兹		
報價單	报价单		
報稅單	报税单		
塗油於	涂油于		
壞份子	坏分子		
大別山	大别山		
夾塞兒	夹塞儿		
夾娃娃	夹娃娃		
夾尾巴	夹尾巴		
夾山寺	夹山寺		
夾竹桃	夹竹桃		
夾肢窩	夹肢窝		
夾腳拖	夹脚拖		
存款單	存款单		
季羨林	季羡林		
對著幹	对着干		
尼米茲	尼米兹		
居住於	居住于		
巴別塔	巴别塔		
布勞恩	布劳恩		
座標法	坐标法		
座標系	坐标系		
弗蘭茲	弗兰兹		
形於色	形于色		
徐繼畬	徐继畲		
得益於	得益于		
德勒茲	德勒兹		
心願單	心愿单		
怎麼著	怎么着		
意味著	意味着		
成績單	成绩单		
托克勞	托克劳		
提貨單	提货单		
收藏夾	收藏夹		
文件夾	文件夹		
文徵明	文征明		
明擺著	明摆着		
易建聯	易建联		
普通鵟	普通𫛭		
有助於	有助于		
有悖於	有悖于		
有賴於	有赖于		
本徵值	本征值		
杜尚別	杜尚别		
柏遼茲	柏辽兹		
棕尾鵟	棕尾𫛭		
植根於	植根于		
極座標	极坐标		
橫座標	横坐标		
歐亞鵟	欧亚𫛭		
止損單	止损单		
毛腿鵟	毛腿𫛭		
民建聯	民建联		
波茲南	波兹南		
波茲坦	波兹坦		
波茲曼	波兹曼		
洛佩茲	洛佩兹		
涅槃經	涅盘经		
無期別	无期别		
熱乾麵	热干面		
牛肉乾	牛肉干		
牧伕座	牧夫座		
獨聯體	独联体		
琅琊區	琅玡区		
瑯琊區	琅琊区		
瓦杜茲	瓦杜兹		
瓦都茲	瓦都兹		
甦家屯	苏家屯		
男子單	男子单		
相當於	相当于		
看著辦	看着办		
眼乾症	眼干症		
瞧著辦	瞧着办		
等著瞧	等着瞧		
綜合徵	综合征		
縱座標	纵坐标		
繃著臉	绷着脸		
美聯儲	美联储		
美聯社	美联社		
老著臉	老着脸		
耶洗別	耶洗别		
聯軸器	联轴器		
聯軸節	联轴节		
肉夾饃	肉夹馍		
自乾五	自干五		
艾茲病	艾兹病		
茲沃勒	兹沃勒		
華爾茲	华尔兹		
菲爾茲	菲尔兹		
著勁兒	着劲儿		
著道兒	着道儿		
葡萄乾	葡萄干		
行程單	行程单		
說著玩	说着玩		
變調夾	变调夹		
資料夾	资料夹		
走著瞧	走着瞧		
起徵點	起征点		
躡著腳	蹑着脚		
車釐子	车厘子		
這麼著	这么着		
通知單	通知单		
醉心於	醉心于		
重覆性	重复性		
阿聯酋	阿联酋		
陸徵祥	陆征祥		
雨夾雪	雨夹雪		
韓昇洙	韩升洙		
韓聯社	韩联社		
領料單	领料单		
魚乾女	鱼干女		
鱷魚夾	鳄鱼夹		
麥當勞	麦当劳		
一乾二淨	一干二净		
一勞永逸	一劳永逸		
三聯書店	三联书店		
不乾不淨	不干不净		
不勞無獲	不劳无获		
不勞而獲	不劳而获		
不絕於耳	不绝于耳		
不絕於途	不绝于途		
不辭而別	不辞而别		
中國殘聯	中国残联		
么麼小醜	幺麽小丑		
乳臭未乾	乳臭未干		
了然於胸	了然于胸		
五勞七傷	五劳七伤		
人浮於事	人浮于事		
以免藉口	以免借口		
以逸待勞	以逸待劳		
任勞任怨	任劳任怨		
伊於胡底	伊于胡底		
何濟於事	何济于事		
偶聯反應	偶联反应		
克勞修斯	克劳修斯		
克勞福德	克劳福德		
克萊懞特	克莱蒙特		
內在座標	内在坐标		
公之於眾	公之于众		
公諸於世	公诸于世		
分門別類	分门别类		
分離份子	分离分子		
列別傑夫	列别杰夫		
別來無恙	别来无恙		
別出心裁	别出心裁		
別太客氣	别太客气		
別樹一幟	别树一帜		
別樹一旗	别树一旗		
別開生面	别开生面		
利祿薰心	利禄薰心		
勞勞叨叨	劳劳叨叨		
勞拉西泮	劳拉西泮		
勞斯萊斯	劳斯莱斯		
勞民傷財	劳民伤财		
勞燕分飛	劳燕分飞		
勞而無功	劳而无功		
千差萬別	千差万别		
反動份子	反动分子		
反叛份子	反叛分子		
口乾舌燥	口干舌燥		
史特勞斯	史特劳斯		
右派份子	右派分子		
吃飽撐著	吃饱撑着		
咬著耳朵	咬着耳朵		
哭喪著臉	哭丧着脸		
唾面自乾	唾面自干		
問道於盲	问道于盲		
單刀直入	单刀直入		
單刀赴會	单刀赴会		
單反相機	单反相机		
單口相聲	单口相声		
單板滑雪	单板滑雪		
單核細胞	单核细胞		
單根獨苗	单根独苗		
單槍匹馬	单枪匹马		
單翼飛機	单翼飞机		
單連接站	单连接站		
嚴於律己	严于律己		
囉曼帶克	罗曼带克		
國際棋聯	国际棋联		
國際田聯	国际田联		
國際足聯	国际足联		
外強中乾	外强中干		
多勞多得	多劳多得		
多氯聯苯	多氯联苯		
大溪豆乾	大溪豆干		
天壤之別	天壤之别		
天淵之別	天渊之别		
夾七夾八	夹七夹八		
夾起尾巴	夹起尾巴		
好逸惡勞	好逸恶劳		
婦姑勃谿	妇姑勃溪		
嫁禍於人	嫁祸于人		
孤獨於世	孤独于世		
富於想像	富于想像		
寓教於樂	寓教于乐		
專美於前	专美于前		
工於心計	工于心计		
座標空間	坐标空间		
形單影隻	形单影只		
徵名責實	征名责实		
念茲在茲	念兹在兹		
愛德華茲	爱德华兹		
拉文克勞	拉文克劳		
拙於言詞	拙于言词		
按勞分配	按劳分配		
捷爾梅茲	捷尔梅兹		
擬於不倫	拟于不伦		
敵特份子	敌特分子		
於事無補	于事无补		
於心不忍	于心不忍		
施特勞斯	施特劳斯		
普立茲獎	普立兹奖		
本徵向量	本征向量		
析毫剖釐	析毫剖厘		
染指於鼎	染指于鼎		
棋高一著	棋高一着		
棕翅鵟鷹	棕翅𫛭鹰		
業荒於嬉	业荒于嬉		
極右份子	极右分子		
極端份子	极端分子		
步步高陞	步步高升		
武裝份子	武装分子		
死於安樂	死于安乐		
死於非命	死于非命		
毫釐不爽	毫厘不爽		
氣定神閒	气定神闲		
求助於人	求助于人		
求道於盲	求道于盲		
法茲魯拉	法兹鲁拉		
活躍份子	活跃分子		
溢於言表	溢于言表		
激進份子	激进分子		
灰臉鵟鷹	灰脸𫛭鹰		
烈火乾柴	烈火干柴		
烏茲別克	乌兹别克		
無動於中	无动于中		
無動於衷	无动于衷		
無徵不信	无征不信		
無濟於事	无济于事		
照單全收	照单全收		
犬馬之勞	犬马之劳		
玻爾茲曼	玻尔兹曼		
珠聯璧合	珠联璧合		
異議份子	异议分子		
疲於奔命	疲于奔命		
直角座標	直角坐标		
看著不管	看着不管		
瞭若指掌	了若指掌		
硬著頭皮	硬着头皮		
祕而不宣	秘而不宣		
神勞形瘁	神劳形瘁		
神祕莫測	神秘莫测		
移情別戀	移情别恋		
積勞成疾	积劳成疾		
積於忽微	积于忽微		
窮於應付	穷于应付		
納粹份子	纳粹分子		
繁徵博引	繁征博引		
羞於啟齒	羞于启齿		
老於世故	老于世故		
老虎伍茲	老虎伍兹		
耿耿於懷	耿耿于怀		
聊勝於無	聊胜于无		
聞名於世	闻名于世		
聯席會議	联席会议		
聯席董事	联席董事		
聯產到勞	联产到劳		
聯調聯試	联调联试		
聯體別墅	联体别墅		
背夾電池	背夹电池		
能者多勞	能者多劳		
脊柱側彎	脊椎侧弯		
臨川羨魚	临川羡鱼		
臨河羨魚	临河羡鱼		
臨淵羨魚	临渊羡鱼		
臻於完善	臻于完善		
臻於郅治	臻于郅治		
舉手之勞	举手之劳		
茲事體大	兹事体大		
茲卡病毒	兹卡病毒		
華茲華斯	华兹华斯		
萊布尼茲	莱布尼兹		
萬國郵聯	万国邮联		
落於下風	落于下风		
著稱於世	著称于世		
著著失敗	着着失败		
藉詞推搪	借词推搪		
血濃於水	血浓于水		
衣單食薄	衣单食薄		
視微知著	视微知着		
請別見怪	请别见怪		
賈夾威德	贾夹威德		
輕於鴻毛	轻于鸿毛		
遷怒於人	迁怒于人		
重於泰山	重于泰山		
鐵爾梅茲	铁尔梅兹		
閒來無事	闲来无事		
閒言閒語	闲言闲语		
阿布哈茲	阿布哈兹		
阿茲特克	阿兹特克		
雁杳魚沈	雁杳鱼沉		
雙人包夾	双人包夹		
雙瞳翦水	双瞳剪水		
離家別井	离家别井		
難於接近	难于接近		
難於登天	难于登天		
霄壤之別	霄壤之别		
霍爾木茲	霍尔木兹		
霸王別姬	霸王别姬		
顛覆份子	颠覆分子		
鬧著玩兒	闹着玩儿		
凱法勞尼亞	凯法劳尼亚		
別赫捷列夫	别赫捷列夫		
單克隆抗體	单克隆抗体		
單源多倍體	单源多倍体		
單葉雙曲面	单叶双曲面		
小別勝新婚	小别胜新婚		
於霧靄之中	于雾霭之中		
比埃茲巴伯	比埃兹巴伯		
泰格·伍茲	泰格·伍兹		
烏茲衝鋒槍	乌兹冲锋枪		
牽著鼻子走	牵着鼻子走		
耦聯晶體管	耦联晶体管		
聯立方程式	联立方程式		
苛政猛於虎	苛政猛于虎		
莫爾茲比港	莫尔兹比港		
著三不著兩	着三不着两		
西米德蘭茲	西米德兰兹		
費用報銷單	费用报销单		
躺著也中槍	躺着也中枪		
鏽胸藍姬鶲	锈胸蓝姬鹟		
鏽腹短翅鶇	锈腹短翅鸫		
鏽臉鉤嘴鶥	锈脸钩嘴鹛		
鏽額斑翅鶥	锈额斑翅鹛		
防患於未然	防患于未然		
阿拉乾山脈	阿拉干山脉		
非洲單源說	非洲单源说		
韋爾弗雷茲	韦尔弗雷兹		
事實勝於雄辯	事实胜于雄辩		
像那麽回事兒	像那么回事儿		
吃不了兜著走	吃不了兜着走		
單鏡反光相機	单镜反光相机		
拉茲莫夫斯基	拉兹莫夫斯基		
摸著石頭過河	摸着石头过河		
畢其功於一役	毕其功于一役		
笛卡兒座標制	笛卡儿坐标制		
蘇格蘭摺耳貓	苏格兰折耳猫		
身教勝於言教	身教胜于言教		
鏽紅腹旋木雀	锈红腹旋木雀		
乾打雷，不下雨	干打雷，不下雨		
占著茅坑不拉屎	占着茅坑不拉屎		
對著和尚罵賊禿	对着和尚骂贼秃		
拿著雞毛當令箭	拿着鸡毛当令箭		
揣著明白裝糊塗	揣着明白装糊涂		
放著明白裝糊塗	放着明白装糊涂		
站著說話不腰疼	站着说话不腰疼		
索爾茲伯里平原	索尔兹伯里平原		
索爾茲伯里石環	索尔兹伯里石环		
肅清反革命份子	肃清反革命分子		
這山望著那山高	这山望着那山高		
單端孢霉烯類毒素	单端孢霉烯类毒素		
太陽照在桑乾河上	太阳照在桑干河上		
夾山國家森林公園	夹山国家森林公园		
筆勝於刀文比武強	笔胜于刀文比武强		
青出於藍而勝於藍	青出于蓝而胜于蓝		
一著不慎，滿盤皆輸	一着不慎，满盘皆输		
千里之堤，潰於蟻穴	千里之堤，溃于蚁穴		
千里之行，始於足下	千里之行，始于足下		
吃著碗裡，看著鍋裡	吃着碗里，看着锅里		
吃著碗裡，瞧著鍋裡	吃着碗里，瞧着锅里		
失之毫釐，差之千里	失之毫厘，差之千里		
失之毫釐，差以千里	失之毫厘，差以千里		
差之毫釐，失之千里	差之毫厘，失之千里		
差之毫釐，謬以千里	差之毫厘，谬以千里		
己所不欲，勿施於人	己所不欲，勿施于人		
生於憂患，死於安樂	生于忧患，死于安乐		
金烏西墜，玉兔東昇	金乌西坠，玉兔东升		
兄弟鬩於墻，外禦其侮	兄弟阋于墙，外御其侮		
步子太大，容易扯著蛋	步子太大，容易扯着蛋		
單絲不成線，獨木不成林	单丝不成线，独木不成林		
小隱隱於林，大隱隱於市	小隐隐于林，大隐隐于市		
小隱隱於野，大隱隱於市	小隐隐于野，大隐隐于市		
帶著希望去旅行，比到達終點更美好	带着希望去旅行，比到达终点更美好		