raystorm	RAYSTORM
raywood	Raywood
matrixai	MATRIXAI
priest	Priest
vivibear	Vivibear
立透cai	立透CAI
刹那vs基拉	刹那VS基拉
夜末p	夜末P
失眠a梦	失眠A梦
*牵机*	牵机
永恒之皇者.CS	永恒之皇者
南无袈裟理科佛、	南无袈裟理科佛
文舟.	文舟
安之。	安之
大 种 马	大种马
边城 浪子	边城·浪子
鲁班尺1	鲁班尺
乱世狂刀01	乱世狂刀
七尺居士0	七尺居士
自在WADE	自在
黑猫不怕黑（KAKA）	黑猫不怕黑
御坂1OO86	御坂10086
笑得像朵老菊花儿	笑的像朵老菊花
接口卡	接卡口
L易安	易安
比那名居流儀	比那名居桃子
笑狮拔剑	笑獅拔劍
弦之韵	弦之韻
三角四方圈圈叉	三角四方圈圈叉叉
月下沚鸿	月下
圣崇成功	圣崇因成
伯倫希爾	伯伦希尔
李北雨	李北羽
我恨我失踪的账号	我恨我失踪的帐号
纱罗双树	沙罗双树
耳东水寿	儿东水寿
血珊瑚  魔盗	蓝晶
亘古孤寂  诸天仙武	亘古孤寂2
风月先生  钢铁王座	风月
弹指一笑间0	弹指一笑间
薛定谔牛(蚕茧里的牛)	蚕茧里的牛
薛定谔牛	蚕茧里的牛
大爆炸(灰熊猫)  窃明	大爆炸
灰熊猫  窃明	大爆炸
奥巴牛总统(周郎羡)	周郎羡
奥巴牛总统	周郎羡
童亮(亮兄)	亮兄
童亮	亮兄
猛虎道长(西门飞雪)  立道庭	猛虎道长
西门飞雪  立道庭	猛虎道长
端午正阳(中秋月明)  叛徒	中秋月明
端午正阳  叛徒	中秋月明
端午正阳(中秋月明)  舵爷	端午正阳
中秋月明  舵爷	端午正阳
巴比伦的天空花园(幻灭之风)	巴比伦的天空花园
幻灭之风	巴比伦的天空花园
猫丸(鱼丸)	鱼丸
猫丸	鱼丸
重生亚当  贾羽(甲鱼不是龟)	贾羽
重生亚当  甲鱼不是龟	贾羽
诗中伏笔(X六叶)	诗中伏笔
X六叶	诗中伏笔
庚新(明镜)	庚新
明镜	庚新
谢绝假言(成九龙)	谢绝假言
成九龙	谢绝假言
夏南柳(流浪的法神本尊)	夏南柳
流浪的法神本尊	夏南柳
醉卧笑伊人(墨染红尘01)	醉卧笑伊人
墨染红尘01	醉卧笑伊人
四行(瑶池里的竹子)	四行
瑶池里的竹子	四行
曹三公子(曹昇)	曹三公子
曹昇	曹三公子
雾满拦江(崔金生)	雾满拦江
崔金生	雾满拦江
提刀狼顾(雷宇)	提刀狼顾
雷宇	提刀狼顾
pener（巴孤）	pener(巴孤)
网龙	网 龙
网  龙	网 龙
森	森*
逆苍天.	逆苍天
马可·菠萝	马可菠萝
黑色柳丁~	黑色柳丁
随便.写写	随便写写
鱼的天空.	鱼的天空
键盘的灰.	键盘的灰
水瓶座·杰	水瓶座杰
大 种 马	大种马
【辛夷坞】	辛夷坞
kl3300	KL3300
So糊涂	SO糊涂
醉·生梦死	醉生.梦死
忘记·密码	忘记密码
天下_第二	天下第二
路人ja	路人JA
灯火阑珊.	灯火阑珊
李歆.	李歆
萧玄武.	萧玄武
So期待	SO期待
红叶*	红叶
TV帝、	TV帝
疏离.	疏离
醉今朝.	醉今朝
十三°	十三
黑色_尼古丁	黑色尼古丁
芋·头	芋头
烟波客·冷月	烟波客冷月
沉 沦	沉沦
 清水慢文	清水慢文
童鼎鼎.	童鼎鼎
blue安琪儿	BLUE安琪儿
萧莫愁、	萧莫愁
爱要长久.	爱要长久
tpfood	Tpfood
皮诺·曹	皮诺曹
奔放的程序员、	奔放的程序员
临渊.羡鱼	临渊羡鱼
☆撒加	撒加
苏 芷	苏芷
 寂小贼	寂小贼
行道迟迟.	行道迟迟
*上善若水*	上善若水
光·兴	光兴
我不知道。	我不知道
§诺言	诺言
飞幻.	飞幻
随风★月下	随风月下
嫌疑人x	嫌疑人X
殊同_	殊同
printer22	Printer22
 月下嗷狼	月下嗷狼
锦瑟五十弦.	锦瑟五十弦
草 根	草根
吐槽是福！	吐槽是福
红颜悴相思碎	红颜悴，相思碎
春风十里不如你	春风十里，不如你
历史课代表	.历史课代表
金衣公子★	金衣公子
【天凉】好个秋	天凉好个秋
青琦_	青琦
司北北.	司北北
雪dee	雪DEE
双罗树下 沙加	双罗树下沙加
Chenfuwrong	CHENFUWRONG
（他年）	他年
道...	道
【沉默】	沉默
奉孝先生.	奉孝先生
小猫。	小猫
.小不点	小不点
疯狂的poi	疯狂的Poi
nickelhavoc	NickelHavoc
Mk	MK
迪奥·布兰度	迪奥布兰度
心意难平.	心意难平
无名小生.	无名小生
黎光.	黎光
无痕·无恨	无痕无恨
在？	在.
aixs	Aixs
常·幽	常幽
芜湖，起飞	芜湖起飞
士途.	士途
百万单机王.	百万单机王
（幽径独酌）	幽径独酌
（一纸清白）	一纸清白
（痒笔）	痒笔
（遗址）	遗址
（夜冷）	夜冷
藤萍（叶萍萍）	藤萍
非安(书坊)	非安
二雷不用狙(3G)	二雷不用狙
炮轰南天门(纵横)	炮轰南天门
白面黑厮(书坊)	白面黑厮
唐家三少（网文之王）	唐家三少
天蚕土豆(合作)	天蚕土豆
威武武威(书坊)	威武武威
漠北狼（我是特种兵）	.漠北狼.
求无欲(出版)	求无欲
媚媚猫（青函）	媚媚猫
不妖（晋朝商人）	不妖
丁墨(书坊)	丁墨
雨中之鹰(书坊)	雨中之鹰
海之角(书坊)	海之角
落落叶儿(书坊)	落落叶儿
五十块(书坊)	五十块
寒逸轩(书坊)	寒逸轩
诸葛神偷(书坊)	诸葛神偷
夏白雪(书坊)	夏白雪
步步（原名步飞烟)	步步
道.	道
昨日之日（龙空ID：guwucn）	昨日之日
沧海楼主(书坊)	沧海楼主
s.x.q.	s.x.q.
D.T.A.	D.T.A.
每天(ha)(ha)(ha)	每天(ha)(ha)(ha)
贾羽(甲鱼不是龟)	贾羽
甲鱼不是龟	贾羽
yang9398（杨鹏）	yang9398
杨鹏	yang9398
梦游居士（月关）	月关
梦游居士	月关
