OVERLORD 不死者之王	Overlord 不死者之王
日曜转生（日耀转生）	日曜转生
龙族（1-4合集）	龙族
若星汉天空（内地实体版）	若星汉天空
太阳de距离	太阳的距离
伊塔之	伊塔之柱
q	Q
杨戬——人生长恨水长东	人生长恨水长东
鬼吹灯（盗墓者的经历）	鬼吹灯
二鬼子汉奸李富贵（曲线救国续集）	二鬼子汉奸李富贵
觉醒-仿如昨日	觉醒－仿如昨日
[综武侠]故国神游	故国神游
明朝那些事儿（全七册）	明朝那些事儿
敛财人生[综].	敛财人生[综]
医道官途.	医道官途
诛仙青云志	诛仙·青云志
大宋小吏。	大宋小吏
大宋小吏.	大宋小吏
网游之修罗传说2：天辰	网游之修罗传说2:天辰
伯符的恐怖故事集0	伯符的恐怖故事集
长相思1	长相思
三生三世枕上书（终篇）	三生三世枕上书
bug之神	BUG之神
末日倒计时	末日：倒计时
我和DJJ有个约会	我和DJ有个约会
.皇家宠婢	皇家宠婢
明	《明》
中日战争  -第三次世界大战的序幕	中日战争——第三次世界大战的序幕
那片星空那片海	那片星空，那片海
绝世 兵王	绝世兵王
维多利亚的秘密1850	维多利亚的秘密
我秀天帝	我，秀天帝
王瑾的悠哉日常	RE：王瑾的悠哉日常
Psychology 思维空洞	Psychology思维空洞
（修真）师姐的剑	修真-师姐的剑
搞鬼—废柴道士的爆笑生活1	搞鬼1：废柴道士的爆笑生活
搞鬼：废柴道士的爆笑生活1	搞鬼1：废柴道士的爆笑生活
搞鬼—废柴道士的爆笑生活2	搞鬼2：废柴道士的爆笑生活
镇魔曲八部众之星术	镇魔曲：八部众之星术
《万古神帝》	万古神帝
假装是个boss	假装是个BOSS
最后一个道士2	最后一个道士Ⅱ
穿入中世纪我的历史大佬群	穿入中世纪，我的历史大佬群
武极天下.	武极天下
《炼道长生》	炼道长生
所有深爱的都是秘密	所有深爱的，都是秘密
福泽有余重生	福泽有余[重生]
知否知否应是绿肥红瘦	知否？知否？应是绿肥红瘦
全天堂都以为上司失宠了.	全天堂都以为上司失宠了
吾皇万岁	吾皇，万岁
《穿越者穿越了穿越者》	穿越者穿越了穿越者
皇家小娇娘.	皇家小娇娘
[红楼]宠后之路.	[红楼]宠后之路
绝对臣服[足球].	绝对臣服[足球]
神|魔	神魔
Re：从零开始的异世界生活	Re:从零开始的异世界生活
护花高手在都市-	护花高手在都市
[快穿]女主，请回头Ⅱ	[快穿]女主，请回头2
（综）尖叫女王	[综]尖叫女王
大修真时代1.0	大修真时代
校花的贴身高手.	校花的贴身高手
黄庭.A	黄庭
Psychology 灵魂拼图	Psychology灵魂拼图
穿成潘金莲怎么破！	穿成潘金莲怎么破~
穿成潘金莲怎么破。	穿成潘金莲怎么破~
穿呀主神	穿呀！主神
苗疆蛊事Ⅱ	苗疆蛊事2
小甜恋（手游卡牌）	小甜恋[手游卡牌]
太阳的距离.A	太阳的距离
明朝那些事儿1	明朝那些事儿
大佬都爱我 [快穿]	大佬都爱我[快穿]
斗罗大陆外传唐门英雄传	斗罗大陆外传：唐门英雄传
爸这好像是北宋	爸，这好像是北宋
[综]信长独奏曲.	[综]信长独奏曲
三生三世十里桃花	三生三世，十里桃花
三生三世 十里桃花	三生三世，十里桃花
IF主神欢迎你	主神欢迎你
鲜血之座黑铁之冠	鲜血之座，黑铁之冠
最后的三国2兴魏	最后的三国2：兴魏
双鹰旗下1	双鹰旗下
杯雪.	杯雪
三生三世枕上书全集	三生三世枕上书
三生三世枕上书（全集）	三生三世枕上书
干了这碗恒河水穿越印度	干了这碗恒河水（穿越印度）
《巅峰对决》	巅峰对决
精装恶人谷	精装恶人谷！
斗罗大陆III龙王传说	斗罗大陆3龙王传说
惊奇物语.1	惊奇物语
星际药师	[星际]药师
(HP-FW)黛拉·布什的恋爱故事	黛拉·布什的恋爱故事
网游——屠龙巫师	网游－屠龙巫师
罪全书4——张翰主演十宗罪原著	罪全书4：张翰主演十宗罪原著
赤城﻿	赤城
剑碟	剑谍
仓元图	沧元图
绝代双娇	绝代双骄
烈女传	列女传
異世界女神傳	异世界女神传
宫略	宮略
网生记	往生记
龙族5	龙族
有翡	有匪
五千年来谁着史	五千年来谁著史
风诡传说	风鬼传说
仙子请自重（问道红尘）	问道红尘
仙子请自重	问道红尘
斗罗大陆IV终极斗罗	斗罗大陆Ⅳ终极斗罗
斗罗大陆4终极斗罗	斗罗大陆Ⅳ终极斗罗
恐怖修仙世界（诡异修仙世界）	诡异修仙世界
恐怖修仙世界	诡异修仙世界
我有一座恐怖屋（我有一座冒险屋）	我有一座冒险屋
我有一座恐怖屋	我有一座冒险屋
恐怖在线中	诡异在线中
鬼喊抓鬼	狩魂者之鬼喊抓鬼
易鼎【完结】	易鼎
老婆请自重	老婆请安分
注视深渊	熟睡之后
门 徒	门徒
艳照门徒	门徒
瘟疫医生	黎明医生
女友都想捅死我	我才不要恋爱游戏
身体交换游戏	人生交换游戏
恶灵国度	诡秘国度
多塔界  蚕茧里的牛	魔兽多塔之异世风云
问鼎  何常在	官神
极品马贼  墨武	江山美色
混迹在美女如云公司  天堂羽	女总裁爱上我
阴阳冕  唐家三少	酒神
虛境修仙  百里玺	紫府仙缘
道尽轮回  乘风御剑	无上真身
穿越之纨绔少爷  贼眉鼠眼	传奇纨绔少爷
绝世好毒  豆子惹的祸	小仙有毒
很纯很暧昧前传  鱼人二代	重生追美记
黑客江湖  银河九天	疯狂的硬盘
诛仙录  逐没	兽行天下
超级魔法帝国  小分队长	超魔杀帝国
秘界（秘界寻奇）	秘界(秘界寻奇)
秘界(秘界寻奇)	秘界(秘界寻奇)
仕途风流  断刃天涯	扬帆宦海
淘宝笔记  罗晓	无双宝鉴
我的妹妹是COSER？	我的妹妹是COSER?
美女赢家  灵宇 	全音阶狂潮
黄金瞳(典当)  打眼	黄金瞳
典当  打眼	黄金瞳
魔兽多塔之异世风云(多塔界)	魔兽多塔之异世风云
多塔界	魔兽多塔之异世风云
官神(问鼎)  何常在	官神
江山美色(极品马贼)	江山美色
极品马贼	江山美色
女总裁爱上我(混迹在美女如云公司)	女总裁爱上我
混迹在美女如云公司	女总裁爱上我
酒神(阴阳冕)	酒神
阴阳冕	酒神
紫府仙缘(虛境修仙)	紫府仙缘
虛境修仙	紫府仙缘
无上真身(道尽轮回)	无上真身
道尽轮回	无上真身
传奇纨绔少爷(穿越之纨绔少爷)	传奇纨绔少爷
穿越之纨绔少爷	传奇纨绔少爷
小仙有毒(绝世好毒)	小仙有毒
绝世好毒	小仙有毒
很纯很暧昧前传(重生追美记)	很纯很暧昧前传
重生追美记	很纯很暧昧前传
疯狂的硬盘(黑客江湖)  银河九天	疯狂的硬盘
血符（尤物禁书）	血符
尤物禁书	血符
兽行天下(诛仙录)  逐没	兽行天下
超魔杀帝国(超级魔法帝国)	超魔杀帝国
超级魔法帝国	超魔杀帝国
扬帆宦海(仕途风流)	扬帆宦海
仕途风流	扬帆宦海
无双宝鉴(淘宝笔记)	无双宝鉴
淘宝笔记	无双宝鉴
终极猎杀(特种兵魂)	终极猎杀
特种兵魂	终极猎杀
我的极品美女老师(狂野艳逍遥)	我的极品美女老师
狂野艳逍遥	我的极品美女老师
重生世家子(重生红三代)  蔡晋	重生世家子
重生红三代  蔡晋	重生世家子
官路风流(侯卫东官场笔记)	官路风流
侯卫东官场笔记	官路风流
最穿越(花都大少)  萧瑟朗	花都大少
最穿越  萧瑟朗	花都大少
洪荒天子(轩辕绝)  龙人	洪荒天子
轩辕绝  龙人	洪荒天子
七星招魂幡(搬山道人)  冬雪晚晴	七星招魂幡
搬山道人  冬雪晚晴	七星招魂幡
浩然剑(谢苏)  赵晨＆光清朗	浩然剑
谢苏  赵晨＆光清朗	浩然剑
历史的尘埃(死灵法师的仆人)  知秋	历史的尘埃
死灵法师的仆人  知秋	历史的尘埃
重生之钢铁大亨(官场之风流人生)  更俗	重生之钢铁大亨
官场之风流人生  更俗	重生之钢铁大亨
灭神记(血刃冰锋)  心梦无痕	灭神记
血刃冰锋  心梦无痕	灭神记
爱你我就骚扰你(求爱大作战)  柳下挥	爱你我就骚扰你
求爱大作战  柳下挥	爱你我就骚扰你
首席御医(首席医官)  银河九天	首席御医
首席医官  银河九天	首席御医
魔法元首李维(和女精灵的地球生活)  李家成功	魔法元首李维
和女精灵的地球生活  李家成功	魔法元首李维
上古强身术(美女图)  我是多余人	上古强身术
美女图  我是多余人	上古强身术
娶个姐姐当老婆  博得之门	阴魂
娶个姐姐当老婆  博德之门	阴魂
娶个姐姐当老婆  野原乳之熊	阴魂