果断	sự quyết đoán
感谢	lòng biết ơn
到来	sự đến nơi
光	ánh sáng
出现	sự xuất hiện
爱	tình yêu
回归	sự trở về
美	vẻ đẹp
微笑	nụ cười
喜好	sự yêu thích
痴迷	sự si mê
伤	thương thế
毁灭	sự huỷ diệt
发展	sự phát triển
进步	sự tiến bộ
沉重	sự trầm trọng
同意	sự đồng ý
喜悦	sự vui sướng
注意	sự chú ý
存在	tồn tại
吼叫	tiếng gầm
死亡	cái chết
死	cái chết
错	lỗi
厉害	sự lợi hại
归来	sự trở về
承诺	lời hứa
汪洋	uông dương
谎言	lời nói dối
下落	tăm tích
