raystorm	RAYSTORM
raywood	Raywood
matrixai	MATRIXAI
priest	Priest
vivibear	Vivibear
立透cai	立透CAI
刹那vs基拉	刹那VS基拉
夜末p	夜末P
失眠a梦	失眠A梦
*牵机*	牵机
永恒之皇者.CS	永恒之皇者
南无袈裟理科佛、	南无袈裟理科佛
文舟.	文舟
安之。	安之
大 种 马	大种马
边城·浪子	边城 浪子
鲁班尺1	鲁班尺
乱世狂刀01	乱世狂刀
七尺居士0	七尺居士
自在WADE	自在
黑猫不怕黑（KAKA）	黑猫不怕黑
御坂1OO86	御坂10086
笑得像朵老菊花儿	笑的像朵老菊花
接口卡	接卡口
L易安	易安
比那名居流儀	比那名居桃子
笑狮拔剑	笑獅拔劍
弦之韵	弦之韻
三角四方圈圈叉	三角四方圈圈叉叉
月下沚鸿	月下
圣崇成功	圣崇因成
伯倫希爾	伯伦希尔
李北雨	李北羽
我恨我失踪的账号	我恨我失踪的帐号
纱罗双树	沙罗双树
耳东水寿	儿东水寿
魔盗  血珊瑚	蓝晶
诸天仙武  亘古孤寂	亘古孤寂2
钢铁王座  风月先生	风月
弹指一笑间0	弹指一笑间
薛定谔牛(蚕茧里的牛)	蚕茧里的牛
薛定谔牛	蚕茧里的牛
窃明  大爆炸(灰熊猫)	大爆炸
窃明  灰熊猫	大爆炸
奥巴牛总统(周郎羡)	周郎羡
奥巴牛总统	周郎羡
童亮(亮兄)	亮兄
童亮	亮兄
立道庭  猛虎道长(西门飞雪)	猛虎道长
立道庭  西门飞雪	猛虎道长
叛徒  端午正阳(中秋月明)	中秋月明
叛徒  端午正阳	中秋月明
舵爷  端午正阳(中秋月明)	端午正阳
舵爷  中秋月明	端午正阳
巴比伦的天空花园(幻灭之风)	巴比伦的天空花园
幻灭之风	巴比伦的天空花园
猫丸(鱼丸)	鱼丸
猫丸	鱼丸
重生亚当  贾羽(甲鱼不是龟)	贾羽
重生亚当  甲鱼不是龟	贾羽
诗中伏笔(X六叶)	诗中伏笔
X六叶	诗中伏笔
庚新(明镜)	庚新
明镜	庚新
谢绝假言(成九龙)	谢绝假言
成九龙	谢绝假言
夏南柳(流浪的法神本尊)	夏南柳
流浪的法神本尊	夏南柳
醉卧笑伊人(墨染红尘01)	醉卧笑伊人
墨染红尘01	醉卧笑伊人
四行(瑶池里的竹子)	四行
瑶池里的竹子	四行
曹三公子(曹昇)	曹三公子
曹昇	曹三公子
雾满拦江(崔金生)	雾满拦江
崔金生	雾满拦江
提刀狼顾(雷宇)	提刀狼顾
雷宇	提刀狼顾
