其他	Loại khác
玄幻	Huyền ảo
奇幻	Kỳ huyễn
幻想	Giả tưởng
魔法	Ma pháp
历史	Lịch sử
军事	Quân sự
都市	Đô thị
现实	Hiện thực
职场	Chức trường
官场	Quan trường
校园	Vườn trường
商战	Thương chiến
仙侠	Tiên hiệp
修真	Tu chân
科幻	Khoa viễn
空间	Không gian
游戏	Trò chơi
体育	Thể thao
竞技	Thi đấu
悬疑	Huyền nghi
惊悚	Kinh dị
灵异	Thần quái
同人	Đồng nhân
武侠	Võ hiệp
耽美	Đam mỹ
女生	Nữ sinh
言情	Ngôn tình
穿越	Xuyên việt
宅文	Trạch văn
